year,st,firms,estabs,emp,denom,estabs_entry,estabs_entry_rate,estabs_exit,estabs_exit_rate,job_creation,job_creation_births,job_creation_continuers,job_creation_rate_births,job_creation_rate,job_destruction,job_destruction_deaths,job_destruction_continuers,job_destruction_rate_deaths,job_destruction_rate,net_job_creation,net_job_creation_rate,reallocation_rate,firmdeath_firms,firmdeath_estabs,firmdeath_emp
1978,01,54603,65219,1009566,972179,10484,16.417,7766,12.161,216369,76178,140191,7.836,22.256,142307,60195,82112,6.192,14.638,74062,7.618,29.276,5247,5328,28142
1978,02,7114,8399,106711,107525,1925,23.812,1295,16.019,35135,14504,20631,13.489,32.676,36645,18446,18199,17.155,34.08,-1510,-1.404,65.352,828,834,8783
1978,04,40034,48169,697947,652945,9561,20.498,6510,13.957,196778,79220,117558,12.133,30.137,106222,47993,58229,7.35,16.268,90556,13.869,32.536,4429,4517,25170
1978,05,36903,42200,567917,543616,7228,17.545,5223,12.678,123432,49350,74082,9.078,22.706,74461,31985,42476,5.884,13.697,48971,9.008,27.395,3862,3887,17119
1978,06,388190,465362,7254593,6909599,83522,18.492,56148,12.431,1772592,672686,1099906,9.736,25.654,1083335,476987,606348,6.903,15.679,689257,9.975,31.357,37541,38087,220630
1978,08,55128,64191,910814,855579,12336,19.793,8607,13.81,239032,87998,151034,10.285,27.938,128374,57626,70748,6.735,15.004,110658,12.934,30.009,5926,6009,29475
1978,09,56216,63937,1158507,1130307,8077,12.848,5936,9.442,202362,60628,141734,5.364,17.903,146436,54420,92016,4.815,12.955,55926,4.948,25.911,3965,4016,20262
1978,10,9942,11495,218528,214461,1532,13.518,1208,10.659,38940,11702,27238,5.456,18.157,30099,9986,20113,4.656,14.035,8841,4.122,28.069,814,826,5055
1978,11,12736,14622,306735,294192,1960,13.535,1679,11.594,66302,18269,48033,6.21,22.537,42269,16399,25870,5.574,14.368,24033,8.169,28.736,1019,1042,5560
1978,12,165165,196719,2642278,2517025,36369,19.023,25292,13.229,669305,265809,403496,10.56,26.591,417937,191112,226825,7.593,16.604,251368,9.987,33.209,17740,18030,100585
1978,13,82101,99734,1612999,1544619,16225,16.605,12182,12.467,359983,137531,222452,8.904,23.306,223298,93673,129625,6.064,14.457,136685,8.849,28.913,8044,8137,43204
1978,15,15719,18897,282411,271897,3100,16.847,2108,11.456,62660,26644,36016,9.799,23.046,41604,17789,23815,6.543,15.301,21056,7.744,30.603,1327,1348,7430
1978,16,17187,19872,238970,228658,3615,18.695,2545,13.161,60625,24877,35748,10.88,26.513,40207,16351,23856,7.151,17.584,20418,8.929,35.168,1740,1758,8186
1978,17,179096,209379,4033133,3926606,27666,13.384,22320,10.798,734345,247026,487319,6.291,18.702,520410,204518,315892,5.209,13.253,213935,5.448,26.507,14973,15223,85768
1978,18,81309,97493,1765033,1714478,13007,13.535,10213,10.628,309982,100419,209563,5.857,18.08,209576,82545,127031,4.815,12.224,100406,5.856,24.448,6671,6759,33831
1978,19,55840,65265,864825,835643,8729,13.588,6684,10.404,166508,58927,107581,7.052,19.926,107489,43399,64090,5.193,12.863,59019,7.063,25.726,4693,4743,22822
1978,20,46029,53565,703507,681546,7558,14.34,5840,11.08,143852,52919,90933,7.765,21.107,100129,41877,58252,6.144,14.691,43723,6.415,29.383,3995,4036,20808
1978,21,51290,59879,904280,873785,8786,14.898,6979,11.834,185184,65795,119389,7.53,21.193,124528,51687,72841,5.915,14.252,60656,6.942,28.503,4761,4819,21974
1978,22,61484,72709,1169487,1099049,11455,16.1,8336,11.716,295312,105368,189944,9.587,26.87,154167,60850,93317,5.537,14.027,141145,12.842,28.055,5709,5773,28104
1978,23,19760,22518,308291,297435,3344,15.178,2373,10.77,58560,20703,37857,6.961,19.688,36656,15140,21516,5.09,12.324,21904,7.364,24.648,1654,1675,7057
1978,24,60021,71448,1195946,1159273,9714,13.808,7518,10.687,233495,77475,156020,6.683,20.142,160131,63091,97040,5.442,13.813,73364,6.328,27.626,4862,4958,27608
1978,25,95951,110972,2049501,1974118,13345,12.16,10885,9.919,393835,120382,273453,6.098,19.95,242041,105603,136438,5.349,12.261,151794,7.689,24.521,6993,7115,39576
1978,26,127265,151728,2930056,2812563,20790,13.926,15902,10.652,559270,176553,382717,6.277,19.885,324711,148738,175973,5.288,11.545,234559,8.34,23.09,10385,10573,60728
1978,27,67826,79725,1347981,1278514,11289,14.468,7891,10.113,296541,92944,203597,7.27,23.194,158649,68483,90166,5.356,12.409,137892,10.785,24.818,5302,5378,27787
1978,28,35798,41789,595753,572599,6524,15.868,5172,12.58,126588,46778,79810,8.169,22.108,80133,35203,44930,6.148,13.995,46455,8.113,27.989,3517,3541,17305
1978,29,81183,96228,1569165,1506405,14134,14.914,11222,11.841,326482,111277,215205,7.387,21.673,200584,83012,117572,5.511,13.315,125898,8.358,26.631,7431,7569,36555
1978,30,17070,19465,197028,185581,3255,17.059,2487,13.034,51903,17894,34009,9.642,27.968,28873,14319,14554,7.716,15.558,23030,12.41,31.116,1731,1737,7620
1978,31,31294,36061,455146,441841,4717,13.254,3773,10.602,89046,32604,56442,7.379,20.153,62277,25650,36627,5.805,14.095,26769,6.059,28.19,2637,2685,14140
1978,32,14459,16404,284726,262181,3411,21.628,2145,13.601,85379,33340,52039,12.716,32.565,40130,21889,18241,8.349,15.306,45249,17.259,30.612,1466,1479,11086
1978,33,17562,19594,289509,273465,3116,16.378,1979,10.402,63657,25904,37753,9.473,23.278,31938,13060,18878,4.776,11.679,31719,11.599,23.358,1390,1416,6566
1978,34,129472,146930,2409920,2344369,19490,13.441,15634,10.782,475015,161236,313779,6.878,20.262,342528,153327,189201,6.54,14.611,132487,5.651,29.221,10235,10324,66521
1978,35,22020,25508,306365,289748,4744,19.019,3614,14.489,83499,32056,51443,11.063,28.818,50715,25178,25537,8.69,17.503,32784,11.315,35.006,2534,2552,15441
1978,36,313739,353997,5571484,5469179,44295,12.571,41033,11.645,1035579,346693,688886,6.339,18.935,827638,354588,473050,6.483,15.133,207941,3.802,30.266,28689,29022,146490
1978,37,88761,106949,1857684,1787815,16051,15.325,11633,11.107,350219,125269,224950,7.007,19.589,210278,84987,125291,4.754,11.762,139941,7.827,23.523,7765,7834,35321
1978,38,13325,15104,156812,149703,2086,14.063,1545,10.416,33626,11229,22397,7.501,22.462,19382,7994,11388,5.34,12.947,14244,9.515,25.894,1088,1094,5021
1978,39,155681,192802,3589022,3494233,24623,12.942,19543,10.272,643681,198362,445319,5.677,18.421,455592,185670,269922,5.314,13.038,188089,5.383,26.077,12274,12476,63034
1978,40,52170,60471,793484,760738,10123,17.058,7871,13.263,186469,76396,110073,10.042,24.512,121318,53520,67798,7.035,15.947,65151,8.564,31.895,5688,5739,28129
1978,41,50090,57750,781924,728021,10638,19.092,6579,11.807,201896,71148,130748,9.773,27.732,94731,43074,51657,5.917,13.012,107165,14.72,26.024,4675,4703,23426
1978,42,177684,211809,3818000,3744927,25659,12.244,21159,10.097,693011,229612,463399,6.131,18.505,550121,239887,310234,6.406,14.69,142890,3.816,29.38,13484,13727,106296
1978,44,18055,20017,321090,310413,2461,12.448,1967,9.949,61497,20019,41478,6.449,19.811,40343,18190,22153,5.86,12.997,21154,6.815,25.993,1374,1381,8110
1978,45,44540,52502,912115,879351,8347,16.266,5977,11.647,173416,64587,108829,7.345,19.721,108853,46906,61947,5.334,12.379,64563,7.342,24.758,3939,3986,16574
1978,46,14253,15990,169632,161108,2318,14.784,1697,10.823,38343,13267,25076,8.235,23.8,21468,8174,13294,5.074,13.325,16875,10.474,26.65,1178,1185,4578
1978,47,67802,80481,1360038,1310738,12251,15.477,9606,12.135,281480,98828,182652,7.54,21.475,182448,85170,97278,6.498,13.919,99032,7.555,27.839,6452,6514,34325
1978,48,227903,278635,4378439,4161830,49692,18.338,34385,12.689,1105171,434158,671013,10.432,26.555,673430,293692,379738,7.057,16.181,431741,10.374,32.362,23338,23692,148449
1978,49,22971,26503,397127,371729,4934,19.209,3299,12.844,108835,43262,65573,11.638,29.278,58613,25120,33493,6.758,15.768,50222,13.51,31.535,2266,2298,12237
1978,50,10897,12075,157019,150827,1912,16.336,1171,10.005,34837,13040,21797,8.646,23.097,22890,12445,10445,8.251,15.176,11947,7.921,30.353,849,858,8367
1978,51,76442,92653,1491643,1434309,13945,15.4,9739,10.755,312801,110724,202077,7.72,21.808,199038,81302,117736,5.668,13.877,113763,7.932,27.754,6310,6407,34603
1978,53,71711,83882,1137543,1071368,15243,18.86,9120,11.284,280228,92003,188225,8.587,26.156,147330,63263,84067,5.905,13.752,132898,12.405,27.503,6261,6330,32936
1978,54,26590,30883,454912,451600,4209,13.752,3656,11.945,77929,27270,50659,6.039,17.256,70984,23000,47984,5.093,15.718,6945,1.538,31.437,2339,2359,10236
1978,55,78996,91138,1543666,1480734,12190,13.669,8268,9.271,281345,88388,192957,5.969,19.0,156151,62017,94134,4.188,10.546,125194,8.455,21.091,5647,5694,30664
1978,56,10321,11509,130739,119591,2241,20.13,1488,13.366,41998,15927,26071,13.318,35.118,19525,8516,11009,7.121,16.326,22473,18.792,32.653,1019,1031,4557
1979,01,56147,67009,1070302,1041619,9698,14.654,8043,12.153,221612,76499,145113,7.344,21.276,163706,62687,101019,6.018,15.717,57906,5.559,31.433,5561,5621,30694
1979,02,7315,8610,107568,107296,1674,19.664,1480,17.385,27307,10063,17244,9.379,25.45,26952,10304,16648,9.603,25.119,355,0.331,50.239,950,962,5524
1979,04,42568,51188,789457,744983,9190,18.476,6296,12.658,196386,71297,125089,9.57,26.361,107833,42861,64972,5.753,14.475,88553,11.887,28.949,4311,4392,24789
1979,05,37444,42775,591067,578657,6291,14.849,5474,12.921,110083,41537,68546,7.178,19.024,84866,32008,52858,5.531,14.666,25217,4.358,29.332,3991,4028,18579
1979,06,411682,492712,7957222,7623013,82898,17.28,56944,11.87,1806575,644282,1162293,8.452,23.699,1141130,453814,687316,5.953,14.97,665445,8.729,29.939,38567,39061,218515
1979,08,58649,67979,1005086,960647,11997,18.13,8382,12.667,232745,85384,147361,8.888,24.228,143359,59988,83371,6.245,14.923,89386,9.305,29.846,5747,5817,31223
1979,09,58321,66353,1240309,1200304,7895,12.106,5620,8.618,205147,66411,138736,5.533,17.091,124941,48364,76577,4.029,10.409,80206,6.682,20.818,3740,3762,19541
1979,10,10326,11924,227637,223299,1551,13.23,1149,9.801,34108,11905,22203,5.331,15.275,25405,8935,16470,4.001,11.377,8703,3.897,22.754,752,769,3630
1979,11,13087,14998,330578,318998,1875,12.643,1540,10.384,56375,14016,42359,4.394,17.673,33361,12740,20621,3.994,10.458,23014,7.214,20.916,1021,1036,6165
1979,12,175201,208353,2869752,2760894,36229,17.869,25017,12.339,657320,256780,400540,9.301,23.808,438481,188452,250029,6.826,15.882,218839,7.926,31.764,17489,17697,103903
1979,13,84862,103478,1692657,1655789,15632,15.368,12106,11.902,319946,123522,196424,7.46,19.323,246118,94549,151569,5.71,14.864,73828,4.459,29.728,8184,8272,44371
1979,15,16719,20160,304763,294856,3175,16.223,1996,10.199,58550,21791,36759,7.39,19.857,38718,14158,24560,4.802,13.131,19832,6.726,26.262,1343,1363,8062
1979,16,17766,20574,246355,243404,3251,16.062,2584,12.766,49280,19509,29771,8.015,20.246,43609,16200,27409,6.656,17.916,5671,2.33,35.833,1877,1889,9165
1979,17,182438,213478,4203241,4126990,25773,12.175,22186,10.481,718383,232908,485475,5.644,17.407,561658,201311,360347,4.878,13.609,156725,3.798,27.219,14826,15080,82347
1979,18,83618,100492,1870234,1824340,12292,12.399,9582,9.665,299873,98181,201692,5.382,16.437,208489,78913,129576,4.326,11.428,91384,5.009,22.856,6697,6785,34352
1979,19,56777,66427,905456,886567,7878,11.948,6892,10.453,151689,53883,97806,6.078,17.11,113894,43450,70444,4.901,12.847,37795,4.263,25.693,4928,4981,24154
1979,20,47380,55064,750590,728146,7171,13.186,5811,10.685,141827,49130,92697,6.747,19.478,96007,39755,56252,5.46,13.185,45820,6.293,26.37,4019,4071,19972
1979,21,52980,61972,961559,936016,8509,13.948,6577,10.781,179401,66660,112741,7.122,19.166,128759,48372,80387,5.168,13.756,50642,5.41,27.512,4614,4645,22326
1979,22,64292,76135,1236479,1197426,11760,15.819,8173,10.994,265476,94617,170859,7.902,22.171,187437,71802,115635,5.996,15.653,78039,6.517,31.307,5807,5865,36732
1979,23,20361,23251,316603,308785,3063,13.371,2378,10.38,53969,19942,34027,6.458,17.478,38717,13307,25410,4.309,12.538,15252,4.939,25.077,1709,1717,6731
1979,24,62122,74098,1265686,1233402,9671,13.27,7237,9.93,228237,73791,154446,5.983,18.505,163681,62304,101377,5.051,13.271,64556,5.234,26.541,4869,4934,25784
1979,25,98290,113780,2195038,2126086,13022,11.574,10488,9.322,388221,122198,266023,5.748,18.26,252427,92996,159431,4.374,11.873,135794,6.387,23.746,6868,6960,39314
1979,26,131001,156169,3083969,3002047,19103,12.392,15068,9.775,511893,151477,360416,5.046,17.051,347011,116118,230893,3.868,11.559,164882,5.492,23.118,10312,10470,56489
1979,27,70594,82761,1446767,1402386,10644,13.077,7907,9.715,274670,90912,183758,6.483,19.586,185822,71130,114692,5.072,13.25,88848,6.335,26.501,5382,5429,29226
1979,28,37012,43279,614761,606163,6291,14.774,4896,11.498,112304,43131,69173,7.115,18.527,94038,36928,57110,6.092,15.514,18266,3.013,31.027,3425,3456,18399
1979,29,83792,99098,1645428,1610479,13297,13.596,10702,10.943,284061,95832,188229,5.951,17.638,214320,82893,131427,5.147,13.308,69741,4.33,26.616,7345,7433,37911
1979,30,17948,20412,211813,205040,3282,16.44,2384,11.942,45260,17778,27482,8.671,22.074,31859,12548,19311,6.12,15.538,13401,6.536,31.076,1702,1713,8204
1979,31,32365,37164,478273,467856,4532,12.36,3538,9.649,79647,25991,53656,5.555,17.024,58721,23017,35704,4.92,12.551,20926,4.473,25.102,2450,2470,12375
1979,32,15686,17850,327028,308517,3639,21.224,2231,13.012,86499,34536,51963,11.194,28.037,50017,22980,27037,7.449,16.212,36482,11.825,32.424,1541,1552,11686
1979,33,18343,20517,318452,304552,2901,14.446,2031,10.114,63879,21286,42593,6.989,20.975,36277,14574,21703,4.785,11.912,27602,9.063,23.823,1442,1453,6662
1979,34,134177,152235,2549277,2480477,19321,12.901,14382,9.603,462599,150720,311879,6.076,18.65,324981,114459,210522,4.614,13.102,137618,5.548,26.203,9639,9688,48357
1979,35,23020,26580,330928,319865,4411,16.915,3406,13.061,76839,29572,47267,9.245,24.022,54784,24275,30509,7.589,17.127,22055,6.895,34.254,2263,2292,12478
1979,36,318610,359607,5893599,5752846,42442,11.882,37646,10.539,1019350,314461,704889,5.466,17.719,736403,269619,466784,4.687,12.801,282947,4.918,25.601,26810,27092,128988
1979,37,92286,111407,1979019,1926802,15219,13.923,11028,10.089,330210,118086,212124,6.129,17.138,225273,87347,137926,4.533,11.692,104937,5.446,23.383,7704,7794,40903
1979,38,13975,15800,170356,164220,2244,14.505,1586,10.251,35002,14122,20880,8.599,21.314,22823,9262,13561,5.64,13.898,12179,7.416,27.796,1111,1115,5621
1979,39,159817,198000,3766239,3683524,23478,12.0,18772,9.595,614955,210641,404314,5.718,16.695,449719,173088,276631,4.699,12.209,165236,4.486,24.418,12063,12288,64611
1979,40,53938,62650,852879,822331,10120,16.468,7727,12.574,185817,71966,113851,8.751,22.596,123869,51280,72589,6.236,15.063,61948,7.533,30.126,5564,5606,29955
1979,41,52440,60557,826434,805864,9962,16.819,7310,12.342,170427,64672,105755,8.025,21.148,128849,53654,75195,6.658,15.989,41578,5.159,31.978,5153,5212,26823
1979,42,182510,217898,3989772,3908888,24619,11.443,19130,8.891,642341,202814,439527,5.189,16.433,480934,173094,307840,4.428,12.304,161407,4.129,24.607,13095,13271,68176
1979,44,18661,20686,338518,330430,2415,11.853,1792,8.795,58653,19655,38998,5.948,17.751,42272,15401,26871,4.661,12.793,16381,4.957,25.586,1243,1257,6830
1979,45,45774,54311,961251,940229,7684,14.371,6002,11.225,158706,55234,103472,5.875,16.88,116466,41412,75054,4.404,12.387,42240,4.493,24.774,4160,4227,20130
1979,46,14822,16667,180043,175278,2240,13.697,1614,9.869,33475,13069,20406,7.456,19.098,24001,8870,15131,5.061,13.693,9474,5.405,27.386,1171,1175,5347
1979,47,69894,82995,1432003,1400230,11911,14.554,9606,11.737,260404,97900,162504,6.992,18.597,196101,79621,116480,5.686,14.005,64303,4.592,28.01,6593,6641,36084
1979,48,237546,290808,4662830,4511676,48434,17.035,35460,12.472,1054270,411388,642882,9.118,23.368,752954,306885,446069,6.802,16.689,301316,6.679,33.378,24848,25183,165388
1979,49,23931,27653,427786,413174,4576,16.878,3496,12.894,98175,38577,59598,9.337,23.761,69121,27995,41126,6.776,16.729,29054,7.032,33.459,2461,2523,14045
1979,50,11369,12602,163816,160403,1764,14.285,1258,10.187,27641,10051,17590,6.266,17.232,21033,8192,12841,5.107,13.113,6608,4.12,26.225,927,930,4545
1979,51,79620,96564,1587184,1540838,13242,13.977,9596,10.129,296664,99721,196943,6.472,19.253,203476,72606,130870,4.712,13.206,93188,6.048,26.411,6622,6688,32682
1979,53,75635,88268,1219273,1168739,14203,16.475,10087,11.7,277833,92226,185607,7.891,23.772,175994,67484,108510,5.774,15.058,101839,8.714,30.117,6935,7021,35466
1979,54,27663,32133,494024,474236,4604,14.596,3423,10.852,99053,27335,71718,5.764,20.887,59613,24333,35280,5.131,12.57,39440,8.317,25.141,2346,2370,10180
1979,55,81699,94264,1615714,1581200,10965,11.812,8102,8.728,252348,80637,171711,5.1,15.959,183214,65651,117563,4.152,11.587,69134,4.372,23.174,5536,5590,26470
1979,56,11061,12363,143159,137319,2215,18.525,1402,11.726,35661,14406,21255,10.491,25.97,24157,8630,15527,6.285,17.592,11504,8.378,35.184,979,987,5574
1980,01,55813,66921,1064166,1066988,8889,13.275,8970,13.396,174476,66042,108434,6.19,16.352,179993,63368,116625,5.939,16.869,-5517,-0.517,32.704,6295,6358,33360
1980,02,7309,8623,104866,106194,1475,17.12,1460,16.946,23710,9562,14148,9.004,22.327,26339,10512,15827,9.899,24.803,-2629,-2.476,44.654,963,976,4714
1980,04,44518,53589,810157,800496,9343,17.832,6953,13.271,166850,66660,100190,8.327,20.843,147656,56316,91340,7.035,18.446,19194,2.398,36.891,4764,4829,25768
1980,05,37443,42865,590312,591713,5686,13.277,5609,13.097,97599,36116,61483,6.104,16.494,100448,36328,64120,6.139,16.976,-2849,-0.481,32.989,4119,4177,17492
1980,06,424712,507738,8157602,8059105,79733,15.941,64636,12.922,1620741,651795,968946,8.088,20.111,1421370,540900,880470,6.712,17.637,199371,2.474,35.274,44124,44737,251623
1980,08,60470,70056,1040719,1024312,11645,16.873,9566,13.86,212764,84554,128210,8.255,20.771,180418,75551,104867,7.376,17.614,32346,3.158,35.227,6725,6824,39832
1980,09,59125,67341,1265287,1256137,7462,11.16,6511,9.737,185604,63095,122509,5.023,14.776,167095,64574,102521,5.141,13.302,18509,1.473,26.605,4459,4513,21076
1980,10,10358,11895,232278,229949,1363,11.449,1382,11.609,33520,11307,22213,4.917,14.577,29080,10682,18398,4.645,12.646,4440,1.931,25.293,932,958,3858
1980,11,13158,15037,326272,329290,1815,12.111,1714,11.437,56684,19122,37562,5.807,17.214,61645,31838,29807,9.669,18.721,-4961,-1.507,34.428,1122,1138,7012
1980,12,183914,218200,2983727,2926837,36799,17.25,27050,12.68,613789,252094,361695,8.613,20.971,500203,200657,299546,6.856,17.09,113586,3.881,34.18,19382,19631,109802
1980,13,85902,104945,1708834,1705462,14454,13.868,13022,12.494,278648,112392,166256,6.59,16.339,270982,100836,170146,5.913,15.889,7666,0.449,31.778,8831,8934,46135
1980,15,17575,21147,313588,309435,3189,15.446,2186,10.588,54943,22804,32139,7.37,17.756,46896,16347,30549,5.283,15.155,8047,2.601,30.311,1489,1517,8466
1980,16,17805,20642,243587,244913,2990,14.506,2931,14.22,44535,18392,26143,7.51,18.184,46467,18715,27752,7.641,18.973,-1932,-0.789,36.368,2092,2118,9936
1980,17,182781,213857,4104527,4152610,24447,11.439,24169,11.309,568316,218542,349774,5.263,13.686,667509,224435,443074,5.405,16.074,-99193,-2.389,27.372,16463,16667,88037
1980,18,83526,100479,1789899,1828705,11200,11.143,11259,11.202,233332,98382,134950,5.38,12.759,311928,90398,221530,4.943,17.057,-78596,-4.298,25.519,7618,7712,35866
1980,19,56679,66571,895029,899052,7290,10.959,7192,10.811,132327,54435,77892,6.055,14.719,139752,48076,91676,5.347,15.544,-7425,-0.826,29.437,5276,5309,24004
1980,20,47596,55425,761638,756342,6568,11.886,6233,11.28,123567,47563,76004,6.289,16.337,113174,36241,76933,4.792,14.963,10393,1.374,29.927,4462,4506,20472
1980,21,52695,61865,934490,946683,7474,12.071,7573,12.231,139400,58989,80411,6.231,14.725,163870,55177,108693,5.828,17.31,-24470,-2.585,29.45,5313,5351,25207
1980,22,65176,77394,1251313,1242918,10613,13.83,9299,12.118,229450,82724,146726,6.656,18.461,211752,69703,142049,5.608,17.037,17698,1.424,34.073,6663,6729,37444
1980,23,20268,23236,317105,316516,2710,11.655,2742,11.793,46866,17587,29279,5.556,14.807,45722,17401,28321,5.498,14.445,1144,0.361,28.891,1919,1937,8646
1980,24,62994,75080,1292503,1280168,9111,12.214,8137,10.909,222115,76750,145365,5.995,17.35,197041,67932,129109,5.306,15.392,25074,1.959,30.784,5393,5471,28812
1980,25,99443,115255,2249823,2236805,12408,10.832,11001,9.604,350622,110261,240361,4.929,15.675,322481,100748,221733,4.504,14.417,28141,1.258,28.834,7368,7475,40360
1980,26,130894,156607,2895418,3000267,17907,11.447,17554,11.222,362519,135676,226843,4.522,12.083,575021,141831,433190,4.727,19.166,-212502,-7.083,24.166,11903,12048,66970
1980,27,71523,84069,1466163,1457319,9737,11.667,8510,10.197,235628,85317,150311,5.854,16.169,217852,71224,146628,4.887,14.949,17776,1.22,29.898,5960,6049,35127
1980,28,37364,43810,602344,608817,5849,13.43,5331,12.241,98646,41882,56764,6.879,16.203,110935,40678,70257,6.681,18.221,-12289,-2.019,32.406,3804,3833,18132
1980,29,83779,99245,1622738,1634516,11943,12.041,11818,11.915,239450,92524,146926,5.661,14.65,262876,89905,172971,5.5,16.083,-23426,-1.433,29.299,8227,8336,38808
1980,30,17977,20453,207787,209794,2754,13.477,2717,13.296,37577,15980,21597,7.617,17.911,41588,14033,27555,6.689,19.823,-4011,-1.912,35.823,1918,1928,8905
1980,31,32358,37263,478688,478427,4216,11.328,4122,11.076,73501,28799,44702,6.02,15.363,73174,25214,47960,5.27,15.295,327,0.068,30.589,2977,3011,12866
1980,32,16323,18648,339325,334852,3427,18.771,2645,14.488,73450,34781,38669,10.387,21.935,63483,22754,40729,6.795,18.959,9967,2.977,37.917,1897,1922,11679
1980,33,18434,20684,323579,321145,2517,12.213,2366,11.481,52389,19133,33256,5.958,16.313,47828,18299,29529,5.698,14.893,4561,1.42,29.786,1669,1681,9473
1980,34,136337,154675,2564149,2563645,18116,11.801,15783,10.282,400269,139264,261005,5.432,15.613,398791,132525,266266,5.169,15.556,1478,0.058,31.111,11019,11085,55058
1980,35,23199,26861,328832,329584,4108,15.372,3833,14.343,64106,27444,36662,8.327,19.451,65834,24940,40894,7.567,19.975,-1728,-0.524,38.901,2667,2691,14383
1980,36,319233,359937,5893763,5882839,40004,11.117,39849,11.073,884704,291571,593133,4.956,15.039,863940,309366,554574,5.259,14.686,20764,0.353,29.372,28646,28902,145563
1980,37,92837,112399,1971129,1974132,13991,12.501,13029,11.642,281579,109237,172342,5.533,14.263,285588,107589,177999,5.45,14.467,-4009,-0.203,28.527,8985,9098,42978
1980,38,14094,16012,172753,171541,1996,12.544,1796,11.287,31120,12241,18879,7.136,18.141,28702,10200,18502,5.946,16.732,2418,1.41,33.464,1308,1314,5636
1980,39,159856,197878,3690360,3730489,20932,10.573,21140,10.678,511006,193776,317230,5.194,13.698,592091,191529,400562,5.134,15.872,-81085,-2.174,27.396,13603,13790,68562
1980,40,54881,63788,879600,865206,9601,15.193,8408,13.306,178855,74808,104047,8.646,20.672,148889,59211,89678,6.844,17.209,29966,3.463,34.417,6009,6082,32241
1980,41,53416,61739,836134,832111,9673,15.817,8508,13.912,159755,69160,90595,8.311,19.199,153034,59620,93414,7.165,18.391,6721,0.808,36.782,6071,6188,31585
1980,42,181812,217360,4007298,4004633,21767,9.999,22415,10.297,565726,208915,356811,5.217,14.127,558522,196202,362320,4.899,13.947,7204,0.18,27.894,15253,15439,79958
1980,44,18708,20750,335711,337048,2187,10.557,2118,10.224,47858,16610,31248,4.928,14.199,50614,17235,33379,5.114,15.017,-2756,-0.818,28.398,1498,1508,6887
1980,45,46233,55050,944878,940190,7361,13.461,6631,12.126,142971,54383,88588,5.784,15.207,133446,47862,85584,5.091,14.194,9525,1.013,28.387,4556,4638,19627
1980,46,14889,16772,179909,179862,1938,11.586,1849,11.054,29613,12202,17411,6.784,16.464,29630,9829,19801,5.465,16.474,-17,-0.009,32.929,1351,1358,5667
1980,47,70148,83686,1411957,1421914,11052,13.26,10374,12.447,219919,91556,128363,6.439,15.466,239803,89383,150420,6.286,16.865,-19884,-1.398,30.933,7306,7384,38280
1980,48,244282,300068,4833731,4759204,47676,16.142,38230,12.944,1002774,398576,604198,8.375,21.07,849744,305301,544443,6.415,17.855,153030,3.215,35.71,26304,26722,153012
1980,49,23877,27738,432386,430343,4185,15.112,4097,14.794,80055,31607,48448,7.345,18.603,76099,32244,43855,7.493,17.683,3956,0.919,35.367,2891,2929,16550
1980,50,11546,12824,165299,164649,1603,12.607,1386,10.9,25908,9092,16816,5.522,15.735,24330,7892,16438,4.793,14.777,1578,0.958,29.554,1053,1061,4095
1980,51,80495,97818,1613411,1600266,12299,12.655,11030,11.35,259445,95565,163880,5.972,16.213,232951,84328,148623,5.27,14.557,26494,1.656,29.114,7603,7690,35760
1980,53,76439,89435,1247129,1232032,13249,14.914,12054,13.569,244751,91465,153286,7.424,19.866,215588,82210,133378,6.673,17.499,29163,2.367,34.997,8423,8526,45673
1980,54,27517,32032,475079,487175,3831,11.942,3927,12.241,71397,29705,41692,6.097,14.655,94804,32530,62274,6.677,19.46,-23407,-4.805,29.311,2762,2772,11674
1980,55,81895,94696,1602773,1609344,9824,10.396,9431,9.98,212948,75179,137769,4.671,13.232,227116,73977,153139,4.597,14.112,-14168,-0.88,26.464,6659,6725,31931
1980,56,11430,12793,149222,146257,2077,16.506,1657,13.169,33868,13669,20199,9.346,23.156,27969,11489,16480,7.855,19.123,5899,4.033,38.246,1160,1177,6420
1981,01,55365,67106,1063631,1062124,8650,12.907,8471,12.64,176775,76712,100063,7.223,16.644,174560,54036,120524,5.088,16.435,2215,0.209,32.87,6266,6359,32177
1981,02,7660,9030,117618,110745,1647,18.667,1233,13.975,33124,12268,20856,11.078,29.91,19169,7114,12055,6.424,17.309,13955,12.601,34.618,811,816,4004
1981,04,46268,56231,842039,825608,9789,17.834,7105,12.944,169726,77407,92319,9.376,20.558,136577,43263,93314,5.24,16.543,33149,4.015,33.085,5211,5292,27925
1981,05,37155,42921,595032,591929,5577,13.009,5475,12.771,96994,44471,52523,7.513,16.386,91151,27439,63712,4.636,15.399,5843,0.987,30.798,4084,4124,18669
1981,06,433759,522498,8427935,8297265,80693,15.668,65738,12.764,1645453,685815,959638,8.266,19.831,1383654,458856,924798,5.53,16.676,261799,3.155,33.352,46798,47554,268157
1981,08,61960,72527,1092366,1066857,12143,17.04,9615,13.492,238159,104290,133869,9.775,22.323,186933,67563,119370,6.333,17.522,51226,4.802,35.044,7186,7273,43867
1981,09,59704,68368,1293671,1279040,7631,11.249,6573,9.689,190950,82053,108897,6.415,14.929,161580,52732,108848,4.123,12.633,29370,2.296,25.266,4663,4717,22511
1981,10,10390,12043,238467,234085,1421,11.875,1268,10.596,35054,15143,19911,6.469,14.975,26036,7602,18434,3.248,11.122,9018,3.852,22.245,890,905,3914
1981,11,13256,15187,333178,329662,1896,12.538,1766,11.678,54740,21591,33149,6.549,16.605,47923,15816,32107,4.798,14.537,6817,2.068,29.074,1213,1225,7495
1981,12,192197,229744,3184429,3085645,39138,17.48,27465,12.266,687609,303661,383948,9.841,22.284,489811,162629,327182,5.271,15.874,197798,6.41,31.748,20779,21015,107752
1981,13,86964,107313,1776281,1742140,15023,14.16,12589,11.866,322214,137989,184225,7.921,18.495,253944,79669,174275,4.573,14.577,68270,3.919,29.153,9060,9196,46042
1981,15,18066,21788,323865,318480,3101,14.449,2447,11.402,58446,24974,33472,7.842,18.352,47567,14860,32707,4.666,14.936,10879,3.416,29.871,1803,1847,9788
1981,16,17635,20620,244306,244009,2866,13.892,2887,13.994,42689,19047,23642,7.806,17.495,42317,15229,27088,6.241,17.342,372,0.152,34.685,2136,2171,10048
1981,17,182580,215436,4094443,4108867,24891,11.599,23199,10.811,600900,260397,340503,6.337,14.624,630143,169558,460585,4.127,15.336,-29243,-0.712,29.249,16693,16950,96919
1981,18,82906,100830,1780504,1785021,11054,10.984,10662,10.595,242435,98261,144174,5.505,13.582,251486,68787,182699,3.854,14.089,-9051,-0.507,27.163,7703,7828,37908
1981,19,56459,66865,879579,887221,7177,10.761,6838,10.253,131157,69786,61371,7.866,14.783,146846,48241,98605,5.437,16.551,-15689,-1.768,29.566,5253,5335,23016
1981,20,47875,56130,780748,771475,6906,12.385,6169,11.063,132613,52174,80439,6.763,17.19,115438,35370,80068,4.585,14.963,17175,2.226,29.927,4543,4607,21224
1981,21,52516,62238,952673,947104,7532,12.141,7131,11.495,150702,64911,85791,6.854,15.912,139252,40846,98406,4.313,14.703,11450,1.209,29.406,5266,5326,25562
1981,22,66890,79836,1326549,1288332,11445,14.566,8920,11.352,263225,98043,165182,7.61,20.431,185799,61759,124040,4.794,14.422,77426,6.01,28.843,6556,6645,35392
1981,23,20206,23285,319122,318205,2690,11.57,2620,11.269,46598,16632,29966,5.227,14.644,44593,15240,29353,4.789,14.014,2005,0.63,28.028,1931,1945,8110
1981,24,63595,76549,1323578,1309253,9397,12.399,7881,10.398,215095,87282,127813,6.667,16.429,187047,51485,135562,3.932,14.287,28048,2.142,28.573,5515,5613,28188
1981,25,100477,117281,2320793,2291933,12727,10.95,10625,9.141,375453,139628,235825,6.092,16.382,316164,106718,209446,4.656,13.795,59289,2.587,27.589,7340,7489,54821
1981,26,129794,156771,2844879,2871097,17792,11.358,17536,11.195,403466,161063,242403,5.61,14.053,455512,129248,326264,4.502,15.865,-52046,-1.813,28.105,12117,12352,64350
1981,27,71760,84967,1466492,1465459,9616,11.383,8638,10.225,224894,88610,136284,6.047,15.346,222949,67263,155686,4.59,15.214,1945,0.133,30.427,6047,6147,36036
1981,28,37064,43881,614633,609260,5406,12.331,5324,12.144,101104,43981,57123,7.219,16.595,90299,26154,64145,4.293,14.821,10805,1.773,29.642,4069,4119,18217
1981,29,83754,100014,1637177,1629150,12112,12.162,11262,11.308,258395,114484,143911,7.027,15.861,241910,76801,165109,4.714,14.849,16485,1.012,29.698,8203,8320,41232
1981,30,18141,20696,208491,208083,2828,13.746,2584,12.56,38596,15044,23552,7.23,18.548,38173,13480,24693,6.478,18.345,423,0.203,36.69,1876,1894,8359
1981,31,32460,37594,493462,485843,4168,11.136,3837,10.252,81126,30412,50714,6.26,16.698,66497,19533,46964,4.02,13.687,14629,3.011,27.374,2822,2856,12437
1981,32,16881,19455,351421,345326,3507,18.42,2675,14.05,76330,35629,40701,10.317,22.104,63435,23266,40169,6.737,18.37,12895,3.734,36.739,1978,2008,16491
1981,33,18725,21101,335210,329754,2698,12.917,2269,10.863,55566,23312,32254,7.07,16.851,44995,12004,32991,3.64,13.645,10571,3.206,27.29,1663,1700,7755
1981,34,137142,156409,2623087,2587343,18144,11.668,16336,10.505,432527,162694,269833,6.288,16.717,362324,112822,249502,4.361,14.004,70203,2.713,28.007,11698,11835,55242
1981,35,23478,27348,339175,333230,4203,15.513,3695,13.638,72963,31964,40999,9.592,21.896,60997,22190,38807,6.659,18.305,11966,3.591,36.61,2673,2697,13199
1981,36,320027,362863,6031594,5960749,41319,11.436,38232,10.581,989602,349569,640033,5.865,16.602,848177,269148,579029,4.515,14.229,141425,2.373,28.459,28534,28851,161815
1981,37,93228,113897,2018751,1995331,14246,12.593,12709,11.234,305404,137466,167938,6.889,15.306,256860,80956,175904,4.057,12.873,48544,2.433,25.746,9046,9159,42607
1981,38,14220,16318,175723,174095,1990,12.316,1670,10.335,30063,13550,16513,7.783,17.268,26839,7582,19257,4.355,15.416,3224,1.852,30.833,1242,1254,5497
1981,39,159176,199428,3632388,3660474,21925,11.041,20237,10.191,480751,206475,274276,5.641,13.134,537493,144566,392927,3.949,14.684,-56742,-1.55,26.267,14009,14289,70746
1981,40,56444,66121,942297,909279,10490,16.155,8115,12.497,197258,84161,113097,9.256,21.694,131805,44136,87669,4.854,14.496,65453,7.198,28.991,6180,6269,30280
1981,41,53646,62267,822164,828273,9175,14.803,8600,13.876,140364,61919,78445,7.476,16.947,152815,47648,105167,5.753,18.45,-12451,-1.503,33.893,6253,6338,29581
1981,42,179437,217130,4006920,4003627,21769,10.022,21916,10.09,543332,229876,313456,5.742,13.571,539281,150262,389019,3.753,13.47,4051,0.101,26.94,15596,15853,81506
1981,44,18730,20867,337633,336124,2192,10.535,2071,9.954,49809,19938,29871,5.932,14.819,46680,11549,35131,3.436,13.888,3129,0.931,27.776,1499,1522,6777
1981,45,46612,56147,966925,956122,7454,13.409,6338,11.402,153591,68870,84721,7.203,16.064,131917,35647,96270,3.728,13.797,21674,2.267,27.594,4649,4726,21469
1981,46,14690,16669,176113,177866,1831,10.957,1914,11.454,25210,10378,14832,5.835,14.174,28757,8911,19846,5.01,16.168,-3547,-1.994,28.347,1390,1402,5770
1981,47,69838,84183,1426246,1418563,10692,12.742,10148,12.094,226010,98213,127797,6.923,15.932,210465,63480,146985,4.475,14.836,15545,1.096,29.673,7560,7640,36919
1981,48,252535,313953,5171042,4999787,51672,16.839,37466,12.21,1107395,470388,637007,9.408,22.149,764986,261264,503722,5.226,15.3,342409,6.848,30.601,26969,27463,159107
1981,49,24211,28583,433022,434020,4732,16.806,3880,13.78,85472,40774,44698,9.395,19.693,87903,27048,60855,6.232,20.253,-2431,-0.56,39.386,2841,2880,15154
1981,50,11609,12914,169623,167175,1509,11.728,1415,10.997,25898,8258,17640,4.94,15.492,20977,6091,14886,3.643,12.548,4921,2.944,25.096,1039,1046,4227
1981,51,81069,99632,1665291,1639387,12692,12.86,10820,10.963,277176,126889,150287,7.74,16.907,225016,70779,154237,4.317,13.726,52160,3.182,27.451,7787,7936,37957
1981,53,77249,91260,1271425,1258971,13319,14.743,11479,12.706,237418,100048,137370,7.947,18.858,211338,63063,148275,5.009,16.787,26080,2.072,33.573,8278,8369,40225
1981,54,27257,32113,495494,488571,3960,12.351,3860,12.039,80547,36567,43980,7.484,16.486,67094,20132,46962,4.121,13.733,13453,2.754,27.465,2860,2877,13015
1981,55,82240,95796,1600363,1601142,9872,10.369,8695,9.133,219595,99345,120250,6.205,13.715,219874,49884,169990,3.116,13.732,-279,-0.017,27.43,6371,6468,30290
1981,56,11750,13276,160804,154973,2146,16.473,1649,12.658,39279,15307,23972,9.877,25.346,27441,9124,18317,5.887,17.707,11838,7.639,35.414,1241,1246,5958
1982,01,53246,65323,1037579,1053314,7647,11.544,9481,14.313,160288,60483,99805,5.742,15.217,191983,63811,128172,6.058,18.227,-31695,-3.009,30.435,6779,6849,38321
1982,02,8073,9546,130802,124878,1835,19.755,1321,14.221,38865,14912,23953,11.941,31.122,27104,8756,18348,7.012,21.704,11761,9.418,43.409,881,891,4967
1982,04,46909,57655,844541,843199,9518,16.713,8108,14.237,161347,67384,93963,7.991,19.135,158913,49821,109092,5.909,18.846,2434,0.289,37.693,5831,5860,31944
1982,05,36219,42205,578719,587016,5400,12.691,6092,14.317,88831,35081,53750,5.976,15.133,105406,32502,72904,5.537,17.956,-16575,-2.824,30.265,4376,4407,20021
1982,06,428359,520974,8326934,8367577,73728,14.131,75299,14.432,1508319,573469,934850,6.853,18.026,1588347,534957,1053390,6.393,18.982,-80028,-0.956,36.052,52238,52977,293861
1982,08,62515,73871,1115812,1104336,11931,16.297,10610,14.492,229727,88993,140734,8.059,20.802,207126,75339,131787,6.822,18.756,22601,2.047,37.511,7582,7658,41912
1982,09,59314,68259,1288670,1290773,7211,10.557,7308,10.699,178131,58281,119850,4.515,13.8,181157,50033,131124,3.876,14.035,-3026,-0.234,27.601,5114,5189,25068
1982,10,10345,11985,239805,238980,1338,11.133,1405,11.69,32223,9742,22481,4.076,13.484,30724,9738,20986,4.075,12.856,1499,0.627,25.713,953,969,5267
1982,11,13249,15245,319880,329864,1984,13.013,1986,13.026,47516,17601,29915,5.336,14.405,67015,17369,49646,5.266,20.316,-19499,-5.911,28.809,1338,1352,11438
1982,12,193491,233463,3192868,3197426,36637,15.819,32920,14.214,620125,251428,368697,7.863,19.395,629531,211041,418490,6.6,19.689,-9406,-0.294,38.789,24198,24457,133083
1982,13,85807,106969,1774319,1777151,13784,12.863,14160,13.214,292298,112990,179308,6.358,16.448,297205,95197,202008,5.357,16.724,-4907,-0.276,32.895,9813,9934,52635
1982,15,17842,21714,314088,318764,2753,12.653,2841,13.057,50674,21321,29353,6.689,15.897,59804,17717,42087,5.558,18.761,-9130,-2.864,31.794,1997,2017,11962
1982,16,17111,20204,232937,238729,2668,13.072,3079,15.086,38575,17366,21209,7.274,16.159,50045,17773,32272,7.445,20.963,-11470,-4.805,32.317,2165,2177,10182
1982,17,179499,213134,3917542,3996574,23126,10.794,25359,11.836,519948,202658,317290,5.071,13.01,677205,205303,471902,5.137,16.945,-157257,-3.935,26.02,17606,17889,100889
1982,18,81531,99841,1696304,1738851,10454,10.419,11447,11.408,209516,75325,134191,4.332,12.049,294724,80089,214635,4.606,16.949,-85208,-4.9,24.098,7934,8056,39754
1982,19,54157,64832,839609,861129,6309,9.581,8339,12.664,109077,44061,65016,5.117,12.667,151530,49918,101612,5.797,17.597,-42453,-4.93,25.334,5986,6042,27298
1982,20,46960,55465,766606,774610,6531,11.705,7197,12.898,113341,42955,70386,5.545,14.632,129541,41961,87580,5.417,16.723,-16200,-2.091,29.264,5160,5221,28066
1982,21,51541,61585,938468,945993,7400,11.953,8047,12.998,144888,62601,82287,6.617,15.316,159180,48092,111088,5.084,16.827,-14292,-1.511,30.632,5815,5853,27822
1982,22,67923,81532,1338835,1332474,11489,14.236,9838,12.19,258269,95985,162284,7.204,19.383,245578,80520,165058,6.043,18.43,12691,0.952,36.86,7162,7239,44687
1982,23,19729,22889,321582,320536,2483,10.756,2873,12.446,51343,19473,31870,6.075,16.018,48966,18061,30905,5.635,15.276,2377,0.742,30.553,2013,2030,9003
1982,24,63144,76626,1318285,1320034,9071,11.844,8993,11.742,213924,82409,131515,6.243,16.206,216581,66588,149993,5.044,16.407,-2657,-0.201,32.412,6030,6141,34391
1982,25,100189,117637,2324804,2330156,12373,10.532,12049,10.257,324656,111471,213185,4.784,13.933,334400,95686,238714,4.106,14.351,-9744,-0.418,27.866,8285,8369,52332
1982,26,126151,153668,2700367,2751292,16426,10.582,19529,12.582,373113,123078,250035,4.473,13.561,476104,145919,330185,5.304,17.305,-102991,-3.743,27.123,13064,13281,66306
1982,27,70624,84295,1437365,1452631,9087,10.734,9811,11.589,206852,77321,129531,5.323,14.24,236574,67149,169425,4.623,16.286,-29722,-2.046,28.48,6755,6817,34393
1982,28,35693,42710,599970,608468,4974,11.488,6146,14.195,87771,34578,53193,5.683,14.425,104419,36973,67446,6.076,17.161,-16648,-2.736,28.85,4280,4309,20904
1982,29,81176,97889,1608561,1622862,11079,11.197,13200,13.34,238986,88636,150350,5.462,14.726,265703,88196,177507,5.435,16.373,-26717,-1.646,29.452,9069,9188,43765
1982,30,17717,20317,202191,205198,2608,12.72,2980,14.534,35915,14227,21688,6.933,17.503,41902,13998,27904,6.822,20.42,-5987,-2.918,35.005,2045,2059,9384
1982,31,31623,36819,473852,483483,3859,10.372,4632,12.45,65881,25713,40168,5.318,13.626,84777,25995,58782,5.377,17.535,-18896,-3.908,27.253,3206,3276,14070
1982,32,16891,19666,350249,350933,3256,16.645,3048,15.581,72439,31128,41311,8.87,20.642,73125,25864,47261,7.37,20.837,-686,-0.195,41.284,2142,2158,16137
1982,33,18611,21088,344544,339956,2600,12.328,2606,12.356,63173,21702,41471,6.384,18.583,53799,20716,33083,6.094,15.825,9374,2.757,31.651,1784,1803,9707
1982,34,136307,156095,2614842,2616158,17324,11.088,17611,11.272,405539,130014,275525,4.97,15.501,408309,128867,279442,4.926,15.607,-2770,-0.106,31.003,12401,12503,64237
1982,35,23408,27525,348725,344217,4082,14.877,3908,14.243,71956,27128,44828,7.881,20.904,63054,22528,40526,6.545,18.318,8902,2.586,36.636,2717,2746,13651
1982,36,315965,359774,5957748,5964707,39214,10.853,42298,11.707,886610,290940,595670,4.878,14.864,901380,296039,605341,4.963,15.112,-14770,-0.248,29.729,30669,30954,164780
1982,37,92050,113475,1990228,2006691,13389,11.776,13842,12.174,266052,98198,167854,4.894,13.258,297690,93136,204554,4.641,14.835,-31638,-1.577,26.516,9701,9840,45041
1982,38,13998,16166,178097,177070,1881,11.575,2051,12.621,30483,10639,19844,6.008,17.215,28264,9669,18595,5.461,15.962,2219,1.253,31.924,1429,1443,6467
1982,39,155385,196225,3512959,3568043,19881,10.048,23136,11.694,466057,169422,296635,4.748,13.062,576647,165258,411389,4.632,16.161,-110590,-3.099,26.124,15287,15534,78319
1982,40,57641,67804,994073,968169,10696,15.974,9005,13.449,216145,81651,134494,8.434,22.325,163761,60042,103719,6.202,16.915,52384,5.411,33.829,6655,6730,36271
1982,41,51121,60282,767800,797194,8125,13.258,10132,16.532,118910,50525,68385,6.338,14.916,177612,51171,126441,6.419,22.28,-58702,-7.364,29.832,7286,7378,32931
1982,42,176010,214620,3957090,3976352,20918,9.691,23397,10.839,550666,191659,359007,4.82,13.849,588445,172402,416043,4.336,14.799,-37779,-0.95,27.697,15814,16078,82432
1982,44,18372,20536,332015,335172,2019,9.747,2375,11.466,46056,16072,29984,4.795,13.741,52145,15947,36198,4.758,15.558,-6089,-1.817,27.482,1687,1699,9274
1982,45,45755,55732,948368,957514,6871,12.283,7289,13.03,140613,55775,84838,5.825,14.685,159430,46851,112579,4.893,16.65,-18817,-1.965,29.37,5177,5229,26496
1982,46,14239,16217,172313,174793,1743,10.599,2198,13.366,25752,10564,15188,6.044,14.733,30687,9809,20878,5.612,17.556,-4935,-2.823,29.466,1536,1549,6319
1982,47,68230,83181,1403559,1415603,10485,12.528,11506,13.748,220342,86358,133984,6.1,15.565,243065,74182,168883,5.24,17.17,-22723,-1.605,31.13,8183,8290,41911
1982,48,257172,322920,5472562,5323516,50603,15.888,41756,13.11,1193794,433690,760104,8.147,22.425,897467,314202,583265,5.902,16.859,296327,5.566,33.717,29812,30352,181725
1982,49,23790,28456,433713,433562,4158,14.574,4307,15.096,80534,31609,48925,7.291,18.575,80159,28366,51793,6.543,18.488,375,0.086,36.977,3035,3065,17101
1982,50,11606,12959,167407,168454,1601,12.379,1549,11.977,22125,7762,14363,4.608,13.134,24380,8071,16309,4.791,14.473,-2255,-1.339,26.268,1123,1128,4429
1982,51,79863,99294,1654174,1657932,11875,11.935,12278,12.34,252724,92314,160410,5.568,15.243,259555,82886,176669,4.999,15.655,-6831,-0.412,30.487,8460,8580,43681
1982,53,75794,90512,1228862,1244173,12434,13.678,13219,14.542,212305,81725,130580,6.569,17.064,242870,72755,170115,5.848,19.521,-30565,-2.457,34.128,9055,9139,44971
1982,54,26278,31272,484408,488040,3497,11.029,4367,13.773,75889,33814,42075,6.929,15.55,82248,26032,56216,5.334,16.853,-6359,-1.303,31.1,3002,3031,12911
1982,55,80635,94828,1567869,1582604,9507,9.974,10490,11.005,207278,79869,127409,5.047,13.097,237782,70673,167109,4.466,15.025,-30504,-1.927,26.195,7235,7316,32313
1982,56,11764,13490,159326,160135,2168,16.202,1950,14.573,33324,13130,20194,8.199,20.81,34912,11271,23641,7.038,21.802,-1588,-0.992,41.62,1441,1449,7115
1983,01,53789,65458,1008231,1024118,8387,12.824,8272,12.648,169499,63483,106016,6.199,16.551,200692,76692,124000,7.489,19.597,-31193,-3.046,33.101,5195,5325,30995
1983,02,9170,10809,135471,132905,2512,24.684,1247,12.254,37221,16226,20995,12.209,28.006,32287,11830,20457,8.901,24.293,4934,3.712,48.587,834,852,6366
1983,04,49241,60443,855356,851629,10113,17.123,7347,12.44,178146,70506,107640,8.279,20.918,170653,57086,113567,6.703,20.038,7493,0.88,40.077,4875,4945,29875
1983,05,37200,43260,574864,577166,5814,13.603,4777,11.176,92404,32065,60339,5.556,16.01,97218,34532,62686,5.983,16.844,-4814,-0.834,32.02,3336,3384,15729
1983,06,439051,531492,8245235,8272119,75316,14.312,64834,12.32,1560512,538772,1021740,6.513,18.865,1615839,570641,1045198,6.898,19.534,-55327,-0.669,37.729,41966,42777,260744
1983,08,64830,76453,1119636,1119149,12240,16.281,9696,12.897,230602,101670,128932,9.085,20.605,229902,69988,159914,6.254,20.543,700,0.063,41.085,6690,6765,39356
1983,09,60817,69933,1303485,1295636,7965,11.534,6215,9.0,197485,73555,123930,5.677,15.242,182556,54196,128360,4.183,14.09,14929,1.152,28.18,4193,4237,20998
1983,10,10808,12495,248368,244393,1661,13.567,1156,9.443,37928,13027,24901,5.33,15.519,29568,8068,21500,3.301,12.099,8360,3.421,24.197,738,747,3948
1983,11,13857,15866,324229,322461,2250,14.457,1645,10.57,59405,21728,37677,6.738,18.422,56979,17369,39610,5.386,17.67,2426,0.752,35.34,1073,1087,7686
1983,12,204017,245352,3243232,3223943,40363,16.854,28639,11.958,650013,280569,369444,8.703,20.162,611875,214099,397776,6.641,18.979,38138,1.183,37.958,20144,20440,114963
1983,13,89351,110962,1809231,1789541,15813,14.512,11821,10.848,337132,133741,203391,7.473,18.839,299713,110538,189175,6.177,16.748,37419,2.091,33.496,7738,7862,46683
1983,15,18621,22508,310339,311383,3140,14.206,2331,10.546,51887,22138,29749,7.11,16.663,53939,20211,33728,6.491,17.322,-2052,-0.659,33.327,1555,1594,11446
1983,16,17575,20638,235305,234119,2872,14.063,2442,11.957,43398,19357,24041,8.268,18.537,40933,15277,25656,6.525,17.484,2465,1.053,34.968,1660,1689,8203
1983,17,183102,216877,3852971,3889411,25346,11.785,21748,10.112,583070,215006,368064,5.528,14.991,658138,191831,466307,4.932,16.921,-75068,-1.93,29.982,14622,14919,85541
1983,18,82577,100780,1658455,1677544,12055,12.015,11153,11.116,231946,89105,142841,5.312,13.827,269626,75885,193741,4.524,16.073,-37680,-2.246,27.653,7696,7830,37683
1983,19,54873,65412,846404,843779,6870,10.547,6325,9.71,153688,80393,73295,9.528,18.214,150178,50542,99636,5.99,17.798,3510,0.416,35.597,4371,4434,21606
1983,20,48136,56660,740160,753483,6953,12.4,5781,10.31,122157,51918,70239,6.89,16.212,147850,50132,97718,6.653,19.622,-25693,-3.41,32.425,3984,4053,20381
1983,21,52092,61871,935243,936646,7665,12.422,7335,11.887,164543,84550,79993,9.027,17.567,168649,65504,103145,6.993,18.006,-4106,-0.438,35.135,4780,4830,25906
1983,22,69712,83196,1263050,1302277,11198,13.595,9546,11.589,233730,101462,132268,7.791,17.948,313490,88802,224688,6.819,24.072,-79760,-6.125,35.896,6716,6805,44649
1983,23,20163,23357,327160,324344,2895,12.538,2360,10.221,52371,17546,34825,5.41,16.147,46547,16604,29943,5.119,14.351,5824,1.796,28.702,1558,1578,7862
1983,24,66018,79688,1345105,1329885,10359,13.25,7340,9.389,230955,77796,153159,5.85,17.367,200943,66154,134789,4.974,15.11,30012,2.257,30.22,4799,4886,29035
1983,25,102881,120580,2358442,2343334,13617,11.431,10701,8.983,373501,127657,245844,5.448,15.939,343405,104241,239164,4.448,14.655,30096,1.284,29.309,7121,7241,48014
1983,26,130143,157832,2676044,2681531,19457,12.488,15394,9.881,420367,152707,267660,5.695,15.676,431637,133088,298549,4.963,16.097,-11270,-0.42,31.353,9919,10146,63742
1983,27,72541,86160,1417317,1428414,9869,11.575,8078,9.474,215447,87661,127786,6.137,15.083,239192,71576,167616,5.011,16.745,-23745,-1.662,30.166,5315,5397,30026
1983,28,36311,43041,580492,589641,5595,13.05,5259,12.266,90807,33716,57091,5.718,15.4,108840,43985,64855,7.46,18.459,-18033,-3.058,30.801,3356,3407,16479
1983,29,84043,100613,1610950,1610546,13001,13.094,10352,10.426,263247,98181,165066,6.096,16.345,262064,84408,177656,5.241,16.272,1183,0.073,32.544,6792,6929,38163
1983,30,18365,20989,200806,201577,2934,14.207,2261,10.948,37813,16811,21002,8.34,18.759,39726,13238,26488,6.567,19.708,-1913,-0.949,37.517,1531,1557,8309
1983,31,32387,37575,479059,476370,4289,11.53,3536,9.506,82484,36625,45859,7.688,17.315,76894,25257,51637,5.302,16.142,5590,1.173,32.283,2354,2385,11908
1983,32,17274,20070,336750,344100,3166,15.93,2774,13.958,60122,26776,33346,7.781,17.472,75146,23240,51906,6.754,21.838,-15024,-4.366,34.944,1849,1872,11954
1983,33,19366,21929,340231,340386,2967,13.798,2116,9.84,54923,20584,34339,6.047,16.136,54890,18029,36861,5.297,16.126,33,0.01,32.252,1411,1430,8349
1983,34,140370,160282,2644835,2631053,19264,12.175,15160,9.581,445762,144999,300763,5.511,16.942,419768,142312,277456,5.409,15.954,25994,0.988,31.909,10283,10379,55829
1983,35,24578,28750,341941,345492,4569,16.233,3361,11.941,67396,28172,39224,8.154,19.507,74364,24242,50122,7.017,21.524,-6968,-2.017,39.015,2258,2297,13930
1983,36,324139,368089,5947435,5952846,44690,12.281,36316,9.98,961140,331126,630014,5.562,16.146,971623,318632,652991,5.353,16.322,-10483,-0.176,32.292,26083,26419,171052
1983,37,94209,115964,2009511,1997666,14992,13.065,12558,10.944,309584,127882,181702,6.402,15.497,286012,93750,192262,4.693,14.317,23572,1.18,28.635,8762,8903,41831
1983,38,14309,16479,178921,178519,1991,12.198,1677,10.274,33137,16976,16161,9.509,18.562,32623,11354,21269,6.36,18.274,514,0.288,36.549,1163,1187,6192
1983,39,158104,198644,3436429,3460132,21806,11.049,19248,9.752,522631,212213,310418,6.133,15.104,570679,168296,402383,4.864,16.493,-48048,-1.389,30.209,12090,12417,68882
1983,40,59009,69190,922417,958449,10122,14.781,8705,12.711,162502,66434,96068,6.931,16.955,234767,69417,165350,7.243,24.494,-72265,-7.54,33.909,6439,6521,41373
1983,41,51788,60908,760720,764669,8323,13.732,7730,12.753,134220,49858,84362,6.52,17.553,141562,47259,94303,6.18,18.513,-7342,-0.96,35.105,5190,5326,27584
1983,42,180257,218792,3898686,3933515,23884,11.02,19749,9.112,586784,218213,368571,5.548,14.918,656397,190794,465603,4.85,16.687,-69613,-1.77,29.835,12659,12986,76585
1983,44,18574,20684,329880,330715,2184,10.622,1940,9.435,45203,12091,33112,3.656,13.668,46806,15094,31712,4.564,14.153,-1603,-0.485,27.337,1330,1338,7048
1983,45,46770,56960,936440,943194,7724,13.706,6511,11.554,145722,55708,90014,5.906,15.45,159401,50435,108966,5.347,16.9,-13679,-1.45,30.9,4556,4610,23201
1983,46,14524,16477,171183,171613,1885,11.526,1639,10.022,26062,9787,16275,5.703,15.186,26839,8889,17950,5.18,15.639,-777,-0.453,30.373,1100,1124,5209
1983,47,69456,84018,1397522,1404653,11219,13.42,10378,12.414,236524,97733,138791,6.958,16.839,251715,94507,157208,6.728,17.92,-15191,-1.081,33.677,6607,6737,39933
1983,48,268034,335140,5250118,5371445,53033,16.117,40846,12.413,994286,405790,588496,7.555,18.511,1237917,363474,874443,6.767,23.046,-243631,-4.536,37.021,28014,28670,185784
1983,49,24482,29236,426924,430528,4365,15.129,3596,12.464,80061,32622,47439,7.577,18.596,87130,28752,58378,6.678,20.238,-7069,-1.642,37.192,2398,2442,14822
1983,50,11851,13209,167084,167399,1641,12.552,1371,10.486,23087,8311,14776,4.965,13.792,23746,6234,17512,3.724,14.185,-659,-0.394,27.583,960,965,3963
1983,51,82863,102742,1657509,1651327,13275,13.142,9819,9.72,264422,91801,172621,5.559,16.013,251328,80593,170735,4.881,15.22,13094,0.793,30.44,6536,6711,38143
1983,53,79050,93886,1219138,1224421,13948,15.129,10558,11.452,218370,82054,136316,6.701,17.835,227797,70391,157406,5.749,18.604,-9427,-0.77,35.669,6937,7105,39741
1983,54,26392,31384,439920,460377,3735,11.924,3615,11.541,66502,27738,38764,6.025,14.445,107074,37494,69580,8.144,23.258,-40572,-8.813,28.89,2412,2466,13386
1983,55,82760,96886,1521945,1544939,10585,11.055,8302,8.671,209381,80411,128970,5.205,13.553,255213,70364,184849,4.554,16.519,-45832,-2.967,27.105,5463,5574,30918
1983,56,11818,13519,138375,148785,1937,14.349,1898,14.06,25136,11130,14006,7.481,16.894,45721,12611,33110,8.476,30.73,-20585,-13.835,33.788,1340,1359,7478
1984,01,57283,69524,1106073,1057593,10702,15.855,6656,9.861,227794,87232,140562,8.248,21.539,130912,44939,85973,4.249,12.378,96882,9.161,24.757,4909,4964,26365
1984,02,10242,11942,144528,139983,2614,22.975,1485,13.052,37423,16096,21327,11.499,26.734,28353,10401,17952,7.43,20.255,9070,6.479,40.509,1025,1045,6727
1984,04,53013,64445,962049,909376,11374,18.212,7392,11.836,235109,87298,147811,9.6,25.854,130163,52104,78059,5.73,14.313,104946,11.54,28.627,5014,5122,27920
1984,05,39243,45436,624269,600542,7070,15.934,4937,11.127,121639,43851,77788,7.302,20.255,74588,30302,44286,5.046,12.42,47051,7.835,24.84,3565,3640,16838
1984,06,461645,555948,8957863,8586581,85490,15.719,61344,11.279,2002155,731056,1271099,8.514,23.317,1260560,487103,773457,5.673,14.681,741595,8.637,29.361,41915,42672,251095
1984,08,68409,80489,1180853,1151098,13638,17.376,9636,12.277,253850,102639,151211,8.917,22.053,194449,73350,121099,6.372,16.892,59401,5.16,33.785,7028,7113,38762
1984,09,63481,72816,1366205,1336746,8887,12.451,6002,8.409,225569,74148,151421,5.547,16.874,167462,50567,116895,3.783,12.528,58107,4.347,25.055,4267,4323,24115
1984,10,11180,12906,240934,234152,1718,13.526,1309,10.306,41939,14908,27031,6.367,17.911,28532,9712,18820,4.148,12.185,13407,5.726,24.37,882,888,5337
1984,11,13975,16062,338973,331178,2177,13.638,1979,12.397,60803,22082,38721,6.668,18.36,44877,16328,28549,4.93,13.551,15926,4.809,27.101,1376,1394,9218
1984,12,215905,258996,3551788,3400766,43809,17.366,30354,12.032,803888,318307,485581,9.36,23.638,501537,194834,306703,5.729,14.748,302351,8.891,29.496,22270,22611,121531
1984,13,95233,117634,1983931,1896413,18440,16.128,11842,10.357,409544,153035,256509,8.07,21.596,234622,89991,144631,4.745,12.372,174922,9.224,24.744,8151,8259,46898
1984,15,18961,22923,321135,315945,2947,12.978,2515,11.076,56354,21942,34412,6.945,17.837,45908,16584,29324,5.249,14.53,10446,3.306,29.061,1713,1764,9653
1984,16,18416,21555,249016,242198,3232,15.326,2300,10.906,47425,16799,30626,6.936,19.581,34009,13048,20961,5.387,14.042,13416,5.539,28.084,1690,1702,8284
1984,17,186402,220937,4015311,3933792,27259,12.451,23242,10.616,681206,233649,447557,5.94,17.317,514699,205844,308855,5.233,13.084,166507,4.233,26.168,16672,16914,113289
1984,18,85717,104243,1771638,1715560,14409,14.051,11026,10.752,327431,119440,207991,6.962,19.086,215209,97465,117744,5.681,12.545,112222,6.541,25.089,8157,8285,49917
1984,19,55935,66665,859986,853278,7752,11.735,6542,9.903,135933,47484,88449,5.565,15.931,122230,36990,85240,4.335,14.325,13703,1.606,28.65,4800,4877,21800
1984,20,49888,58626,787937,764600,8049,13.963,6089,10.563,148652,52295,96357,6.84,19.442,100876,39993,60883,5.231,13.193,47776,6.249,26.387,4420,4467,23812
1984,21,54774,65076,992102,963995,9385,14.785,6184,9.742,174991,73131,101860,7.586,18.153,118232,40933,77299,4.246,12.265,56759,5.888,24.53,4672,4737,26988
1984,22,71675,85717,1279352,1269771,12557,14.866,10055,11.904,240550,92208,148342,7.262,18.944,221408,71212,150196,5.608,17.437,19142,1.508,34.874,7423,7548,39703
1984,23,21550,24854,346799,336675,3589,14.884,2108,8.742,56766,18421,38345,5.471,16.861,36596,13509,23087,4.012,10.87,20170,5.991,21.74,1462,1486,6659
1984,24,68456,82673,1447828,1395192,11169,13.752,8256,10.165,276761,95453,181308,6.842,19.837,171016,61969,109047,4.442,12.258,105745,7.579,24.515,5735,5823,32067
1984,25,107711,125925,2516965,2428397,15475,12.557,10092,8.189,448830,152096,296734,6.263,18.483,271551,86408,185143,3.558,11.182,177279,7.3,22.365,7028,7125,44558
1984,26,135200,163313,2867351,2735162,20907,13.02,15437,9.613,567034,203033,364001,7.423,20.731,300003,119968,180035,4.386,10.968,267031,9.763,21.937,10758,10941,55098
1984,27,75691,89626,1513199,1465282,11676,13.28,8271,9.407,271318,88671,182647,6.051,18.516,175408,63018,112390,4.301,11.971,95910,6.545,23.942,5795,5918,34070
1984,28,38334,45456,632940,607068,6906,15.604,4509,10.188,125909,51678,74231,8.513,20.741,73526,25499,48027,4.2,12.112,52383,8.629,24.223,3365,3395,15749
1984,29,86756,103717,1695012,1650868,14290,13.984,11238,10.997,308323,107299,201024,6.5,18.676,220711,76887,143824,4.657,13.369,87612,5.307,26.739,8092,8195,41819
1984,30,19283,21961,208671,204779,3320,15.46,2348,10.934,41633,18223,23410,8.899,20.331,33622,10970,22652,5.357,16.419,8011,3.912,32.837,1670,1690,7170
1984,31,33445,38769,509177,494010,4838,12.671,3663,9.594,101591,49558,52033,10.032,20.565,70413,21791,48622,4.411,14.253,31178,6.311,28.507,2663,2700,13002
1984,32,18381,21295,371488,354208,3699,17.879,2488,12.025,80293,30186,50107,8.522,22.668,45702,17292,28410,4.882,12.903,34591,9.766,25.805,1717,1732,9322
1984,33,20911,23605,383925,362779,3677,16.148,2008,8.818,81946,31779,50167,8.76,22.588,39883,14445,25438,3.982,10.994,42063,11.595,21.987,1437,1465,8154
1984,34,145030,165750,2813432,2724877,20759,12.732,15348,9.413,529933,174906,355027,6.419,19.448,353486,121675,231811,4.465,12.973,176447,6.475,25.945,10864,10977,57766
1984,35,25769,29991,380455,361564,4841,16.474,3632,12.359,95191,48451,46740,13.4,26.328,57848,20347,37501,5.628,15.999,37343,10.328,31.999,2576,2611,13035
1984,36,330551,375297,6213823,6085926,45660,12.282,38563,10.373,1054642,363325,691317,5.97,17.329,795371,263762,531609,4.334,13.069,259271,4.26,26.138,28544,28816,151928
1984,37,101527,124047,2170643,2093215,20216,16.843,12180,10.148,390352,133526,256826,6.379,18.648,234864,82927,151937,3.962,11.22,155488,7.428,22.441,9286,9360,50050
1984,38,14847,17084,181931,180472,2228,13.275,1626,9.688,31237,12858,18379,7.125,17.309,28255,8991,19264,4.982,15.656,2982,1.652,31.312,1177,1187,5461
1984,39,163114,204007,3592976,3507492,23723,11.781,18447,9.161,596822,188809,408013,5.383,17.016,423514,140638,282876,4.01,12.075,173308,4.941,24.149,12393,12651,66709
1984,40,60650,71109,932848,926731,11026,15.718,9103,12.977,177562,72704,104858,7.845,19.16,164660,60331,104329,6.51,17.768,12902,1.392,35.536,6977,7056,37989
1984,41,54366,63717,810452,784921,9776,15.689,6968,11.182,165428,59950,105478,7.638,21.076,114065,39923,74142,5.086,14.532,51363,6.544,29.064,5033,5100,22777
1984,42,184433,223563,3988568,3929415,25699,11.618,20984,9.486,635732,208109,427623,5.296,16.179,518944,185276,333668,4.715,13.207,116788,2.972,26.413,14142,14384,105563
1984,44,19289,21396,355977,343076,2558,12.146,1888,8.964,63287,20695,42592,6.032,18.447,37733,12811,24922,3.734,10.998,25554,7.449,21.997,1332,1359,6899
1984,45,50168,60759,1009008,974644,10056,17.079,6300,10.7,186506,69479,117027,7.129,19.136,117709,46887,70822,4.811,12.077,68797,7.059,24.154,4709,4760,25976
1984,46,15054,17063,182855,176921,2222,13.245,1648,9.824,34196,13718,20478,7.754,19.328,22724,9244,13480,5.225,12.844,11472,6.484,25.688,1171,1182,4440
1984,47,73920,89386,1518434,1462979,14024,16.173,8682,10.012,298848,116537,182311,7.966,20.427,187816,70676,117140,4.831,12.838,111032,7.589,25.676,6485,6591,37743
1984,48,279680,348727,5552710,5393111,57300,16.758,43714,12.784,1237673,504696,732977,9.358,22.949,921034,337619,583415,6.26,17.078,316639,5.871,34.156,31418,32132,192732
1984,49,25454,30307,459936,444356,4601,15.451,3543,11.898,93337,34312,59025,7.722,21.005,62560,26395,36165,5.94,14.079,30777,6.926,28.158,2470,2527,14667
1984,50,12749,14145,177408,172422,2128,15.554,1200,8.771,29376,10149,19227,5.886,17.037,19452,6760,12692,3.921,11.282,9924,5.756,22.563,871,877,3916
1984,51,87233,107836,1780514,1717689,15817,15.016,10816,10.268,326393,114854,211539,6.687,19.002,200177,79559,120618,4.632,11.654,126216,7.348,23.308,7805,7907,42303
1984,53,83793,98946,1320021,1283355,15371,15.938,10360,10.742,268764,104800,163964,8.166,20.942,197491,73836,123655,5.753,15.389,71273,5.554,30.777,7351,7426,36150
1984,54,27083,32170,440769,435881,4492,14.136,3706,11.663,72144,27296,44848,6.262,16.551,62084,23259,38825,5.336,14.243,10060,2.308,28.487,2685,2730,12984
1984,55,85442,99873,1602462,1561448,12073,12.269,9139,9.287,258408,81350,177058,5.21,16.549,176053,61626,114427,3.947,11.275,82355,5.274,22.55,6436,6529,32686
1984,56,11939,13667,140154,139343,1936,14.242,1790,13.168,29926,14900,15026,10.693,21.477,28444,10187,18257,7.311,20.413,1482,1.064,40.826,1237,1249,5660
1985,01,58486,71027,1179095,1157133,10148,14.442,8630,12.282,215144,80581,134563,6.964,18.593,171304,70840,100464,6.122,14.804,43840,3.789,29.608,6142,6247,38543
1985,02,10588,12389,151327,147989,2476,20.354,2027,16.663,40618,15964,24654,10.787,27.447,33816,15534,18282,10.497,22.85,6802,4.596,45.701,1495,1509,9926
1985,04,56148,67858,1069329,1015753,12157,18.377,8750,13.227,274652,105302,169350,10.367,27.039,167350,71554,95796,7.044,16.475,107302,10.564,32.951,6129,6248,44311
1985,05,39658,45955,645377,634359,6398,14.001,5879,12.866,118970,43124,75846,6.798,18.754,96667,41524,55143,6.546,15.239,22303,3.516,30.477,4392,4458,23670
1985,06,476759,570960,9329601,9146189,88271,15.666,73269,13.003,1954839,713682,1241157,7.803,21.373,1588667,656603,932064,7.179,17.37,366172,4.004,34.739,50686,51617,365898
1985,08,69727,81973,1221847,1201624,13456,16.566,11962,14.727,253675,94956,158719,7.902,21.111,214276,91513,122763,7.616,17.832,39399,3.279,35.664,8695,8862,57491
1985,09,64992,74540,1454745,1431709,9240,12.541,7513,10.197,224678,69891,154787,4.882,15.693,178356,71105,107251,4.966,12.458,46322,3.235,24.915,5453,5516,37171
1985,10,11525,13282,277240,259338,1815,13.865,1432,10.939,69511,36565,32946,14.099,26.803,34516,13189,21327,5.086,13.309,34995,13.494,26.619,945,964,5930
1985,11,13940,16075,364321,352158,2111,13.14,2092,13.022,80166,22913,57253,6.506,22.764,54693,25161,29532,7.145,15.531,25473,7.233,31.062,1550,1572,15208
1985,12,224687,269555,3775573,3662960,46594,17.63,36051,13.641,849102,342704,506398,9.356,23.181,622587,261153,361434,7.13,16.997,226515,6.184,33.994,26584,27042,164452
1985,13,99240,122110,2139912,2061681,18752,15.645,14244,11.884,452858,168359,284499,8.166,21.965,295200,120548,174652,5.847,14.318,157658,7.647,28.637,9836,10017,63362
1985,15,19062,23007,352215,336599,2828,12.315,2743,11.945,79849,45778,34071,13.6,23.722,50571,21713,28858,6.451,15.024,29278,8.698,30.048,1862,1913,11835
1985,16,18580,21764,254021,251544,3127,14.435,2924,13.498,45894,16970,28924,6.746,18.245,40769,16705,24064,6.641,16.208,5125,2.037,32.415,2110,2143,11240
1985,17,187632,222636,4118007,4067640,26982,12.167,25246,11.384,710276,258624,451652,6.358,17.462,611583,253289,358294,6.227,15.035,98693,2.426,30.071,17905,18298,124951
1985,18,86577,105538,1846002,1808259,13196,12.582,11876,11.324,331500,143915,187585,7.959,18.333,253798,100812,152986,5.575,14.035,77702,4.297,28.071,8398,8591,55512
1985,19,54609,65258,850674,855023,6678,10.124,8083,12.254,125092,45484,79608,5.32,14.63,133113,63112,70001,7.381,15.568,-8021,-0.938,29.261,5899,5994,29101
1985,20,49837,58585,806899,797142,7184,12.259,7215,12.312,140277,52936,87341,6.641,17.598,120233,55971,64262,7.021,15.083,20044,2.514,30.166,5221,5314,30688
1985,21,55318,65626,1028089,1008822,8437,12.911,7875,12.051,170581,62128,108453,6.158,16.909,131762,55759,76003,5.527,13.061,38819,3.848,26.122,5746,5841,30762
1985,22,71397,85430,1273631,1275704,11553,13.502,11824,13.819,233664,88878,144786,6.967,18.316,237567,94031,143536,7.371,18.622,-3903,-0.306,36.633,8666,8828,57189
1985,23,22365,25656,353111,350285,3571,14.14,2769,10.964,61292,23824,37468,6.801,17.498,55633,24507,31126,6.996,15.882,5659,1.616,31.764,1877,1911,10749
1985,24,71110,85672,1540520,1484486,12751,15.151,9730,11.561,320219,121310,198909,8.172,21.571,208545,87451,121094,5.891,14.048,111674,7.523,28.097,6876,7031,51124
1985,25,111036,129728,2626967,2571608,16387,12.821,12549,9.819,456143,133110,323033,5.176,17.738,344597,131425,213172,5.111,13.4,111546,4.338,26.8,8945,9162,72428
1985,26,138185,166628,3022365,2957403,20982,12.719,17648,10.698,567449,229903,337546,7.774,19.187,439957,180332,259625,6.098,14.876,127492,4.311,29.753,12581,12857,84824
1985,27,76419,90534,1588448,1550566,11390,12.645,10469,11.623,291876,105537,186339,6.806,18.824,216082,93892,122190,6.055,13.936,75794,4.888,27.871,7502,7667,53264
1985,28,38434,45747,644237,638262,6147,13.479,5861,12.852,110941,43464,67477,6.81,17.382,99680,40051,59629,6.275,15.617,11261,1.764,31.235,4178,4236,22886
1985,29,88275,105378,1745380,1719508,14095,13.483,12410,11.872,301995,109863,192132,6.389,17.563,249866,112564,137302,6.546,14.531,52129,3.032,29.063,8895,9035,57479
1985,30,19251,21861,206195,207439,2900,13.237,2994,13.666,35790,13395,22395,6.457,17.253,38205,16614,21591,8.009,18.417,-2415,-1.164,34.507,2157,2168,9711
1985,31,33108,38414,516505,513425,4411,11.431,4762,12.34,82387,32023,50364,6.237,16.047,76235,35370,40865,6.889,14.848,6152,1.198,29.697,3501,3542,21440
1985,32,18822,21733,387277,379085,3551,16.506,3113,14.47,78498,27190,51308,7.173,20.707,61961,29457,32504,7.771,16.345,16537,4.362,32.69,2162,2184,15413
1985,33,22273,25071,405988,394018,4035,16.58,2566,10.544,82290,27978,54312,7.101,20.885,58229,24469,33760,6.21,14.778,24061,6.107,29.557,1860,1890,14845
1985,34,149182,170554,2940130,2883077,22536,13.403,17710,10.533,542171,171895,370276,5.962,18.805,430028,161627,268401,5.606,14.916,112143,3.89,29.831,12729,12951,92683
1985,35,26082,30320,400988,390010,4616,15.307,4289,14.222,89175,34672,54503,8.89,22.865,67176,31188,35988,7.997,17.224,21999,5.641,34.448,2983,3017,17152
1985,36,337006,382497,6461797,6353221,49702,13.119,42433,11.2,1113084,368850,744234,5.806,17.52,896500,345321,551179,5.435,14.111,216584,3.409,28.222,31857,32345,198645
1985,37,105364,128334,2261679,2216640,17825,14.125,13539,10.729,381514,136456,245058,6.156,17.211,291443,108122,183321,4.878,13.148,90071,4.063,26.296,9612,9786,58212
1985,38,14598,16834,182911,182473,1849,10.902,2101,12.388,28566,9883,18683,5.416,15.655,27813,10825,16988,5.932,15.242,753,0.413,30.485,1519,1548,7556
1985,39,164373,205037,3713365,3649260,23145,11.317,22098,10.805,606112,196902,409210,5.396,16.609,479681,197826,281855,5.421,13.145,126431,3.465,26.289,14998,15385,99914
1985,40,59907,70461,974723,951935,10118,14.295,10755,15.195,214779,109878,104901,11.543,22.562,168947,72808,96139,7.648,17.748,45832,4.815,35.495,8184,8256,47659
1985,41,55046,64338,837756,823952,9426,14.722,8806,13.753,162847,61852,100995,7.507,19.764,135382,56501,78881,6.857,16.431,27465,3.333,32.862,6286,6461,33948
1985,42,186295,225585,4069753,4032111,26684,11.883,24645,10.975,635467,219610,415857,5.447,15.76,560303,234322,325981,5.811,13.896,75164,1.864,27.792,16685,17083,123230
1985,44,19732,21937,364708,360801,2790,12.877,2250,10.384,59387,20914,38473,5.797,16.46,50997,18900,32097,5.238,14.134,8390,2.325,28.269,1656,1679,11344
1985,45,51797,62709,1069785,1051256,8966,14.524,7015,11.363,184886,66671,118215,6.342,17.587,147398,54660,92738,5.199,14.021,37488,3.566,28.042,5018,5092,29951
1985,46,15050,17062,188608,185760,1990,11.662,1993,11.68,31111,12186,18925,6.56,16.748,25297,9051,16246,4.872,13.618,5814,3.13,27.236,1431,1459,6389
1985,47,75211,91050,1598947,1558117,12775,14.162,11089,12.293,308096,130649,177447,8.385,19.774,227506,95724,131782,6.144,14.601,80590,5.172,29.203,7831,7917,44913
1985,48,283647,353731,5710814,5612622,55592,15.828,50584,14.402,1202829,479917,722912,8.551,21.431,1008043,417381,590662,7.436,17.96,194786,3.47,35.921,36663,37369,243940
1985,49,25725,30580,478829,469342,4663,15.318,4386,14.408,91693,33991,57702,7.242,19.537,72594,30677,41917,6.536,15.467,19099,4.069,30.934,3104,3171,19318
1985,50,13284,14713,182536,179841,2190,15.183,1613,11.182,29988,10964,19024,6.097,16.675,24621,10387,14234,5.776,13.69,5367,2.984,27.381,1183,1201,5540
1985,51,90967,112174,1883817,1831975,17090,15.535,12767,11.605,346200,125483,220717,6.85,18.898,242837,103182,139655,5.632,13.255,103363,5.642,26.511,9381,9532,59746
1985,53,85178,100451,1360996,1341112,14779,14.822,13291,13.33,257037,94816,162221,7.07,19.166,216845,85030,131815,6.34,16.169,40192,2.997,32.338,9240,9391,50532
1985,54,27168,32232,442480,441926,4384,13.613,4327,13.436,68357,28684,39673,6.491,15.468,67489,26897,40592,6.086,15.272,868,0.196,30.543,3177,3235,17330
1985,55,85738,100246,1643593,1624392,11417,11.411,11023,11.018,247415,85213,162202,5.246,15.231,209760,81946,127814,5.045,12.913,37655,2.318,25.826,7939,8119,48329
1985,56,11898,13597,140313,140176,1900,13.939,1967,14.431,27768,11763,16005,8.392,19.809,27535,11263,16272,8.035,19.643,233,0.166,39.286,1365,1376,6212
1986,01,59717,73013,1227117,1206173,10618,14.745,8610,11.957,230163,90713,139450,7.521,19.082,189574,66841,122733,5.542,15.717,40589,3.365,31.434,6051,6172,34987
1986,02,10588,12443,146849,149196,2327,18.741,2274,18.314,35361,15768,19593,10.569,23.701,39970,14375,25595,9.635,26.79,-4609,-3.089,47.402,1623,1652,8937
1986,04,58532,71303,1134304,1102150,12774,18.359,9325,13.402,270174,116765,153409,10.594,24.513,205717,70574,135143,6.403,18.665,64457,5.848,37.33,6578,6654,44042
1986,05,39886,46313,656886,649244,6299,13.657,5919,12.833,119365,46583,72782,7.175,18.385,103760,40228,63532,6.196,15.982,15605,2.404,31.963,4304,4376,22585
1986,06,491115,591612,9663910,9478601,93035,16.008,72146,12.414,2048695,815248,1233447,8.601,21.614,1677535,601064,1076471,6.341,17.698,371160,3.916,35.396,49588,50469,324343
1986,08,70216,83275,1232454,1226245,13456,16.289,12120,14.672,244534,107224,137310,8.744,19.942,232731,91054,141677,7.425,18.979,11803,0.963,37.958,8665,8792,56932
1986,09,67084,77005,1442271,1448638,9924,13.1,7420,9.795,221789,82296,139493,5.681,15.31,231623,60231,171392,4.158,15.989,-9834,-0.679,30.62,5177,5246,30752
1986,10,12132,14033,284690,280792,2103,15.399,1350,9.885,47506,16380,31126,5.833,16.919,39644,11828,27816,4.212,14.119,7862,2.8,28.237,917,930,4852
1986,11,14225,16556,375094,369615,2233,13.688,1748,10.715,63728,26771,36957,7.243,17.242,52658,16675,35983,4.511,14.247,11070,2.995,28.493,1207,1221,9956
1986,12,234183,281985,3976714,3876144,48970,17.76,36473,13.227,886366,379909,506457,9.801,22.867,685178,264491,420687,6.824,17.677,201188,5.19,35.354,26560,26950,165121
1986,13,102959,127296,2250122,2196560,19982,16.026,14762,11.839,440748,173604,267144,7.903,20.065,333236,121320,211916,5.523,15.171,107512,4.895,30.342,10075,10208,64256
1986,15,19393,23598,370164,361565,3113,13.361,2517,10.803,66668,26420,40248,7.307,18.439,49378,17996,31382,4.977,13.657,17290,4.782,27.314,1659,1680,10548
1986,16,18682,21958,258486,256383,3070,14.044,2873,13.143,46419,17796,28623,6.941,18.105,42454,15052,27402,5.871,16.559,3965,1.547,33.118,2012,2037,10070
1986,17,190403,226899,4219216,4169042,27760,12.354,23373,10.402,692805,248452,444353,5.959,16.618,594022,207497,386525,4.977,14.248,98783,2.369,28.497,16302,16565,106397
1986,18,88179,107576,1890084,1868558,13430,12.606,11354,10.657,307669,123060,184609,6.586,16.466,265448,99155,166293,5.306,14.206,42221,2.26,28.412,7750,7923,49147
1986,19,53704,64513,865000,859050,6564,10.114,7334,11.301,143533,62091,81442,7.228,16.708,131965,52390,79575,6.099,15.362,11568,1.347,30.723,5183,5278,27394
1986,20,49597,58653,824579,818134,7218,12.312,7161,12.215,136083,52142,83941,6.373,16.633,123614,44382,79232,5.425,15.109,12469,1.524,30.219,5245,5349,26691
1986,21,56216,66928,1056803,1042306,8865,13.378,7536,11.373,174041,66456,107585,6.376,16.698,144714,52329,92385,5.021,13.884,29327,2.814,27.768,5428,5488,28626
1986,22,70328,84912,1251296,1264010,11354,13.331,11876,13.943,227857,96443,131414,7.63,18.027,252879,86560,166319,6.848,20.006,-25022,-1.98,36.053,8867,8989,51311
1986,23,23477,26924,368024,359796,4100,15.598,2824,10.743,65720,24461,41259,6.799,18.266,49035,18988,30047,5.277,13.629,16685,4.637,27.257,1958,2004,11041
1986,24,74719,90095,1610741,1574706,13275,15.108,8816,10.034,317021,120034,196987,7.623,20.132,245579,82327,163252,5.228,15.595,71442,4.537,31.19,5969,6089,42161
1986,25,114672,134276,2692446,2658727,17763,13.461,13122,9.944,457632,161827,295805,6.087,17.212,390173,120585,269588,4.535,14.675,67459,2.537,29.35,9136,9307,67410
1986,26,141098,171077,3188936,3102225,21870,12.955,17351,10.278,557910,198547,359363,6.4,17.984,384177,134754,249423,4.344,12.384,173733,5.6,24.768,12335,12532,74296
1986,27,77143,91866,1602416,1595699,11584,12.701,10262,11.252,266334,101665,164669,6.371,16.691,251682,88900,162782,5.571,15.773,14652,0.918,31.545,7150,7294,54647
1986,28,38947,46456,668890,657227,6097,13.227,5377,11.665,126726,47355,79371,7.205,19.282,102980,36391,66589,5.537,15.669,23746,3.613,31.338,3721,3773,19441
1986,29,90023,108173,1799681,1772389,14972,14.027,12107,11.342,323298,128303,194995,7.239,18.241,268597,103673,164924,5.849,15.155,54701,3.086,30.309,8556,8774,55486
1986,30,19082,21809,202720,204487,2911,13.332,2964,13.574,34989,15254,19735,7.46,17.111,38408,14230,24178,6.959,18.783,-3419,-1.672,34.221,2162,2181,9911
1986,31,32694,38126,518961,518179,4105,10.724,4408,11.516,77286,30043,47243,5.798,14.915,75687,25627,50060,4.946,14.606,1599,0.309,29.213,3177,3218,15930
1986,32,19321,22489,406742,398085,3864,17.48,3097,14.01,82257,33106,49151,8.316,20.663,64894,28104,36790,7.06,16.302,17363,4.362,32.603,2178,2207,14842
1986,33,24019,27087,425327,416131,4802,18.416,2778,10.654,87058,35099,51959,8.435,20.921,67705,27421,40284,6.59,16.27,19353,4.651,32.54,2029,2051,12416
1986,34,153689,175627,2991078,2962006,23431,13.54,18287,10.567,529168,182692,346476,6.168,17.865,469502,151946,317556,5.13,15.851,59666,2.014,31.702,12969,13113,75124
1986,35,26378,30932,397231,399123,4842,15.813,4220,13.781,75715,34270,41445,8.586,18.97,79201,29074,50127,7.284,19.844,-3486,-0.873,37.941,2967,3011,16459
1986,36,342888,389750,6604886,6521682,50163,12.994,42784,11.082,1122865,395488,727377,6.064,17.217,958249,343160,615089,5.262,14.693,164616,2.524,29.387,31439,31826,180000
1986,37,109151,133417,2338908,2300374,18977,14.504,13819,10.562,388740,150978,237762,6.563,16.899,313280,114660,198620,4.984,13.619,75460,3.28,27.237,9589,9764,54748
1986,38,14470,16784,181031,182124,1805,10.738,1855,11.036,27044,10869,16175,5.968,14.849,28949,9706,19243,5.329,15.895,-1905,-1.046,29.699,1333,1362,6278
1986,39,167095,209147,3794726,3753749,24603,11.882,20420,9.862,604861,217246,387615,5.787,16.114,522083,179634,342449,4.785,13.908,82778,2.205,27.817,13731,13992,86198
1986,40,58289,69309,951401,963011,9505,13.602,10647,15.236,165307,75520,89787,7.842,17.166,188742,70301,118441,7.3,19.599,-23435,-2.434,34.331,7929,8038,40765
1986,41,56480,66097,857466,849777,9885,15.158,8113,12.441,160359,64112,96247,7.545,18.871,144542,55273,89269,6.504,17.009,15817,1.861,34.019,5775,5842,32731
1986,42,191795,232524,4160601,4110708,28899,12.619,21862,9.546,679282,256362,422920,6.236,16.525,577959,194372,383587,4.728,14.06,101323,2.465,28.12,14913,15218,93103
1986,44,20444,22702,377168,370047,3002,13.462,2197,9.852,61287,20458,40829,5.528,16.562,47227,19285,27942,5.212,12.762,14060,3.8,25.525,1542,1555,10034
1986,45,53482,64918,1078052,1060627,9280,14.546,7036,11.029,196308,78078,118230,7.361,18.509,160793,58705,102088,5.535,15.16,35515,3.348,30.32,4830,4912,28146
1986,46,15033,17139,187076,188054,1899,11.099,1839,10.749,28434,11176,17258,5.943,15.12,30437,9848,20589,5.237,16.185,-2003,-1.065,30.24,1276,1283,6041
1986,47,76873,93394,1657531,1624411,13142,14.253,10767,11.677,304163,114876,189287,7.072,18.725,236497,88696,147801,5.46,14.559,67666,4.166,29.118,7456,7609,47563
1986,48,285264,358744,5675863,5692497,54971,15.433,49869,14.001,1111195,474506,636689,8.336,19.52,1144259,407422,736837,7.157,20.101,-33064,-0.581,39.041,35922,36638,232807
1986,49,25857,30981,488208,486373,4700,15.27,4296,13.958,96665,40944,55721,8.418,19.875,92809,35544,57265,7.308,19.082,3856,0.793,38.164,2996,3047,20079
1986,50,13749,15278,192559,187330,2329,15.536,1755,11.707,35483,14482,21001,7.731,18.941,25385,9445,15940,5.042,13.551,10098,5.391,27.102,1273,1281,6177
1986,51,95027,117723,2010712,1945307,17209,14.974,11622,10.112,384250,158682,225568,8.157,19.753,253307,87219,166088,4.484,13.021,130943,6.731,26.043,7931,8048,44716
1986,53,87230,103264,1420335,1394650,15705,15.42,12879,12.645,290161,108070,182091,7.749,20.805,238743,90622,148121,6.498,17.118,51418,3.687,34.237,8946,9094,49733
1986,54,27244,32373,439364,437422,3992,12.358,3852,11.925,74346,31421,42925,7.183,16.996,70425,26050,44375,5.955,16.1,3921,0.896,32.2,2652,2695,12806
1986,55,86189,101045,1666071,1653831,11528,11.455,10720,10.652,255739,96045,159694,5.807,15.463,231246,92189,139057,5.574,13.982,24493,1.481,27.965,7199,7323,44616
1986,56,11591,13329,135269,138326,1729,12.842,1999,14.847,24473,10526,13947,7.61,17.692,30487,11677,18810,8.442,22.04,-6014,-4.348,35.385,1430,1445,7047
1987,01,60981,74692,1208884,1205940,10740,14.543,9059,12.267,222197,86146,136051,7.143,18.425,215803,80628,135175,6.686,17.895,6394,0.53,35.79,6136,6262,39266
1987,02,10009,11835,140319,143651,1932,15.92,2534,20.88,32943,15856,17087,11.038,22.933,39855,17256,22599,12.012,27.744,-6912,-4.812,45.865,1730,1793,10941
1987,04,60458,74068,1168758,1155853,13157,18.102,10383,14.286,264188,124734,139454,10.792,22.857,238009,100618,137391,8.705,20.592,26179,2.265,41.183,7109,7188,51993
1987,05,39927,46607,687527,675046,6463,13.911,6170,13.28,129344,52251,77093,7.74,19.161,104555,41320,63235,6.121,15.489,24789,3.672,30.977,4377,4440,24583
1987,06,504699,609399,10055041,9938404,96307,16.039,78435,13.062,2206858,877501,1329357,8.829,22.205,1973876,728448,1245428,7.33,19.861,232982,2.344,39.722,53012,54058,366120
1987,08,70177,83498,1203546,1227409,13133,15.748,12922,15.495,239543,110207,129336,8.979,19.516,288918,107900,181018,8.791,23.539,-49375,-4.023,39.032,8867,9061,57653
1987,09,69446,79919,1501507,1477239,11257,14.349,8323,10.609,258940,94886,164054,6.423,17.529,209552,77470,132082,5.244,14.185,49388,3.343,28.371,5825,5868,39673
1987,10,12525,14555,280101,291380,2177,15.24,1637,11.46,54948,18200,36748,6.246,18.858,75717,14879,(S),5.106,25.986,-20769,-7.128,37.716,1082,1092,6769
1987,11,14346,16753,391355,383226,2158,12.961,1953,11.729,71294,27566,43728,7.193,18.604,54536,20793,33743,5.426,14.231,16758,4.373,28.462,1272,1292,9782
1987,12,242322,293346,4143695,4063429,51521,17.913,40070,13.932,945223,439317,505906,10.811,23.262,783870,330453,453417,8.132,19.291,161353,3.971,38.582,28682,29092,186104
1987,13,105693,131549,2337202,2311427,20393,15.757,16141,12.472,479359,212943,266416,9.213,20.739,427074,153931,273143,6.66,18.477,52285,2.262,36.953,10764,10942,75447
1987,15,19871,24240,367710,373514,3416,14.286,2760,11.542,80809,32741,48068,8.766,21.635,91327,22465,68862,6.015,24.451,-10518,-2.816,43.27,1763,1814,12528
1987,16,18719,21969,258698,264225,3008,13.693,3005,13.679,48945,20417,28528,7.727,18.524,60472,20126,40346,7.617,22.887,-11527,-4.363,37.048,1976,2010,12164
1987,17,192190,229670,4219001,4236116,28961,12.689,26107,11.438,708057,270599,437458,6.388,16.715,741232,275349,465883,6.5,17.498,-33175,-0.783,33.43,17367,17669,110619
1987,18,89641,109733,1938771,1921496,13940,12.833,11722,10.791,342092,133853,208239,6.966,17.803,309949,111292,198657,5.792,16.131,32143,1.673,32.261,7928,8174,55541
1987,19,53413,64368,884064,884323,7064,10.963,7192,11.162,148153,59072,89081,6.68,16.753,147038,57756,89282,6.531,16.627,1115,0.126,33.254,4792,4859,26444
1987,20,49252,58422,800520,803148,7147,12.21,7371,12.593,144845,66272,78573,8.252,18.035,150986,54025,96961,6.727,18.799,-6141,-0.765,36.069,4997,5094,26870
1987,21,57033,68141,1059810,1078608,9021,13.358,7800,11.55,187855,74366,113489,6.895,17.416,224097,66990,157107,6.211,20.777,-36242,-3.36,34.833,5416,5525,34304
1987,22,67151,81557,1182834,1223808,10176,12.227,13519,16.243,211954,94845,117109,7.75,17.319,293180,119379,173801,9.755,23.956,-81226,-6.637,34.638,9267,9416,61094
1987,23,24774,28450,391329,391372,4568,16.503,3027,10.936,75986,32102,43884,8.202,19.415,78508,24215,54293,6.187,20.06,-2522,-0.644,38.831,2159,2186,15053
1987,24,77260,93697,1689968,1651638,13692,14.903,10050,10.939,342865,139464,203401,8.444,20.759,265210,98692,166518,5.975,16.057,77655,4.702,32.115,6761,6866,49341
1987,25,118238,138755,2773857,2745900,19135,14.016,14666,10.743,489386,189615,299771,6.905,17.822,437412,143808,293604,5.237,15.93,51974,1.893,31.859,10149,10297,76221
1987,26,143597,174839,3168155,3184989,22595,13.065,18812,10.877,535457,195043,340414,6.124,16.812,567952,180271,387681,5.66,17.832,-32495,-1.02,33.624,12789,12976,83365
1987,27,78148,93442,1653529,1630243,11929,12.876,10339,11.16,296004,113417,182587,6.957,18.157,249405,97390,152015,5.974,15.299,46599,2.858,30.597,6897,7023,47001
1987,28,38969,46668,676317,676547,6179,13.269,5979,12.839,120296,50056,70240,7.399,17.781,121492,44874,76618,6.633,17.958,-1196,-0.177,35.562,4051,4102,23917
1987,29,91611,110551,1855214,1834912,15381,14.063,13017,11.902,353378,143926,209452,7.844,19.259,311787,115958,195829,6.32,16.992,41591,2.267,33.984,8763,8925,57684
1987,30,19028,21776,204918,203914,2979,13.672,3006,13.796,40878,16871,24007,8.274,20.047,39023,16290,22733,7.989,19.137,1855,0.91,38.274,2093,2121,9264
1987,31,32577,38141,517552,528598,4194,10.998,4179,10.959,86912,31925,54987,6.04,16.442,111566,30888,80678,5.843,21.106,-24654,-4.664,32.884,2897,2939,16176
1987,32,20170,23481,443911,426739,4187,18.217,3194,13.896,104396,40903,63493,9.585,24.464,70303,27111,43192,6.353,16.474,34093,7.989,32.949,2115,2143,15629
1987,33,25691,29062,445815,440390,5160,18.382,3179,11.325,90292,36243,54049,8.23,20.503,78868,26721,52147,6.068,17.909,11424,2.594,35.817,2265,2298,15704
1987,34,158395,181185,3120845,3080517,25432,14.258,19804,11.103,633678,244240,389438,7.929,20.571,549109,186724,362385,6.061,17.825,84569,2.745,35.65,13823,13967,87585
1987,35,26392,31003,391748,400141,4547,14.682,4480,14.466,84100,36565,47535,9.138,21.018,101158,30520,70638,7.627,25.281,-17058,-4.263,42.035,2976,3031,16814
1987,36,347346,395513,6827265,6731340,52288,13.319,46430,11.827,1263221,481818,781403,7.158,18.766,1067059,381491,685568,5.667,15.852,196162,2.914,31.704,34010,34317,204401
1987,37,111862,137928,2429925,2388094,19479,14.357,14975,11.037,437628,172311,265317,7.215,18.325,355290,146758,208532,6.145,14.878,82338,3.448,29.755,10195,10321,63691
1987,38,14476,16803,181583,184234,1917,11.42,1884,11.223,29163,11448,17715,6.214,15.829,33858,10759,23099,5.84,18.378,-4695,-2.548,31.659,1268,1283,6310
1987,39,169849,213858,3925959,3893476,26396,12.481,21653,10.238,679643,258712,420931,6.645,17.456,616636,234154,382482,6.014,15.838,63007,1.618,31.675,14053,14316,96976
1987,40,56113,67210,875624,923834,8865,12.986,10976,16.078,160883,78227,82656,8.468,17.415,259438,79993,179445,8.659,28.083,-98555,-10.668,34.829,7564,7712,44614
1987,41,57456,67627,890845,888285,10268,15.356,8746,13.08,176558,67484,109074,7.597,19.876,169992,63051,106941,7.098,19.137,6566,0.739,38.274,6151,6208,35815
1987,42,196289,238608,4284050,4232425,29862,12.678,23742,10.079,732031,273873,458158,6.471,17.296,628703,232586,396117,5.495,14.854,103328,2.441,29.709,15800,16066,107436
1987,44,21219,23628,394992,398387,3368,14.535,2456,10.599,69750,26031,43719,6.534,17.508,77942,20976,56966,5.265,19.564,-8192,-2.056,35.016,1780,1808,12448
1987,45,54920,67094,1135612,1110805,9795,14.84,7611,11.531,226849,101597,125252,9.146,20.422,177899,71073,106826,6.398,16.015,48950,4.407,32.031,5166,5246,30851
1987,46,15135,17229,194634,191114,2013,11.716,1919,11.169,34164,14378,19786,7.523,17.876,27320,9730,17590,5.091,14.295,6844,3.581,28.59,1314,1319,5675
1987,47,78716,96332,1688216,1693471,14079,14.841,11140,11.743,322652,127770,194882,7.545,19.053,332965,113195,219770,6.684,19.662,-10313,-0.609,38.105,7629,7719,51768
1987,48,277966,352264,5459337,5574012,51233,14.415,57543,16.19,1070376,490862,579514,8.806,19.203,1295086,516106,778980,9.259,23.234,-224710,-4.031,38.406,39214,40198,263391
1987,49,26207,31403,502255,501324,4799,15.387,4370,14.012,101962,40807,61155,8.14,20.339,100638,35993,64645,7.18,20.074,1324,0.264,40.149,2880,2961,19269
1987,50,14512,16158,207188,200103,2507,15.949,1628,10.357,41457,17603,23854,8.797,20.718,27048,11348,15700,5.671,13.517,14409,7.201,27.034,1164,1172,6154
1987,51,98282,122677,2118876,2071939,18200,15.142,13231,11.008,417988,167855,250133,8.101,20.174,323797,125056,198741,6.036,15.628,94191,4.546,31.255,8870,9016,57376
1987,53,89061,105815,1458909,1433021,16017,15.324,13438,12.856,309354,119849,189505,8.363,21.588,257118,96551,160567,6.738,17.942,52236,3.645,35.885,9198,9354,51292
1987,54,27365,32747,448529,446433,4264,13.1,3871,11.892,79115,33918,45197,7.598,17.722,74792,26496,48296,5.935,16.753,4323,0.968,33.507,2628,2651,13213
1987,55,87982,104151,1756447,1711732,13267,12.936,10089,9.837,307898,133344,174554,7.79,17.988,219528,78127,141401,4.564,12.825,88370,5.163,25.65,6960,7061,43249
1987,56,11093,12754,126055,135091,1577,12.086,2165,16.593,19970,8684,11286,6.428,14.783,37784,11947,25837,8.844,27.969,-17814,-13.187,29.565,1445,1466,6745
1988,01,62297,76605,1241201,1226388,10587,13.984,8788,11.608,219641,90151,129490,7.351,17.91,189415,70237,119178,5.727,15.445,30226,2.465,30.89,6007,6108,36241
1988,02,10024,11877,137248,138665,1976,16.658,1946,16.405,30948,13157,17791,9.488,22.319,33737,14550,19187,10.493,24.33,-2789,-2.011,44.637,1226,1255,6911
1988,04,62012,76424,1205062,1181884,12788,16.982,10547,14.006,271385,115957,155428,9.811,22.962,226149,88343,137806,7.475,19.135,45236,3.827,38.269,7360,7479,50159
1988,05,40147,47205,706512,698079,6309,13.446,5741,12.235,126360,44835,81525,6.423,18.101,109248,42678,66570,6.114,15.65,17112,2.451,31.3,4013,4061,23650
1988,06,517500,627155,10465967,10273349,94365,15.247,77843,12.578,2253861,819191,1434670,7.974,21.939,1867380,707887,1159493,6.891,18.177,386481,3.762,36.354,53295,54462,374527
1988,08,70337,84200,1214575,1207646,12876,15.347,12269,14.624,242015,100627,141388,8.332,20.04,227360,94869,132491,7.856,18.827,14655,1.214,37.653,8667,8791,51466
1988,09,71857,83018,1524397,1508219,11421,14.011,8411,10.319,271870,109776,162094,7.279,18.026,240159,92563,147596,6.137,15.923,31711,2.103,31.847,5928,5991,43435
1988,10,13039,15201,297723,289081,2242,15.063,1609,10.81,57396,21870,35526,7.565,19.855,39897,14265,25632,4.935,13.801,17499,6.053,27.603,1067,1088,7342
1988,11,14492,17136,385941,386479,2286,13.482,1926,11.359,67235,21489,45746,5.56,17.397,67721,19950,47771,5.162,17.523,-486,-0.126,34.794,1289,1298,12226
1988,12,251532,305662,4339544,4246487,52703,17.586,40769,13.603,955320,404170,551150,9.518,22.497,768556,323668,444888,7.622,18.099,186764,4.398,36.197,29745,30275,190614
1988,13,109045,136418,2447252,2396977,20909,15.596,16206,12.088,496164,202178,293986,8.435,20.7,395563,155683,239880,6.495,16.503,100601,4.197,33.005,11083,11261,86169
1988,15,20489,25093,385567,376476,3509,14.227,2653,10.756,72981,28603,44378,7.598,19.385,54979,20652,34327,5.486,14.604,18002,4.782,29.207,1804,1855,10390
1988,16,18992,22412,269542,262747,3067,13.813,2649,11.931,56793,23801,32992,9.059,21.615,43199,17897,25302,6.811,16.441,13594,5.174,32.883,1820,1863,11911
1988,17,195841,235053,4383059,4302073,28914,12.437,23782,10.229,762425,270638,491787,6.291,17.722,600431,222930,377501,5.182,13.957,161994,3.765,27.914,16199,16475,105824
1988,18,91521,112623,2016613,1975017,13930,12.523,11151,10.025,347480,127940,219540,6.478,17.594,265176,92291,172885,4.673,13.427,82304,4.167,26.853,7624,7777,51030
1988,19,53881,65205,934022,910015,6907,10.656,6138,9.469,158819,52765,106054,5.798,17.452,111491,44745,66746,4.917,12.252,47328,5.201,24.503,4239,4321,25220
1988,20,50018,59766,826730,814975,7545,12.759,6285,10.628,147202,61765,85437,7.579,18.062,124463,48696,75767,5.975,15.272,22739,2.79,30.544,4387,4477,27960
1988,21,57944,69677,1107732,1082616,9148,13.27,7670,11.126,207741,80738,127003,7.458,19.189,156912,61929,94983,5.72,14.494,50829,4.695,28.988,5407,5488,31357
1988,22,66119,81065,1195998,1186573,10426,12.817,10982,13.501,229015,88195,140820,7.433,19.301,210704,82390,128314,6.944,17.757,18311,1.543,35.515,7549,7712,46847
1988,23,25982,29916,416901,405112,4577,15.675,3144,10.767,77644,26003,51641,6.419,19.166,54185,18788,35397,4.638,13.375,23459,5.791,26.751,2272,2287,11173
1988,24,80084,97800,1768057,1729656,14250,14.873,10278,10.727,350134,137231,212903,7.934,20.243,272554,94122,178432,5.442,15.758,77580,4.485,31.515,7022,7163,50441
1988,25,121963,143398,2844289,2811034,19173,13.58,14752,10.449,498367,171603,326764,6.105,17.729,431022,147764,283258,5.257,15.333,67345,2.396,30.666,10121,10307,72974
1988,26,147138,179563,3223394,3202619,22819,12.866,18400,10.375,535943,204000,331943,6.37,16.735,497408,174172,323236,5.438,15.531,38535,1.203,31.063,12252,12567,86730
1988,27,79651,95824,1733815,1697772,12001,12.67,9786,10.332,318571,112870,205701,6.648,18.764,246369,90707,155662,5.343,14.511,72202,4.253,29.023,6733,6861,48466
1988,28,39155,47175,703493,691352,6166,13.132,5723,12.189,126192,53567,72625,7.748,18.253,101785,40122,61663,5.803,14.723,24407,3.53,29.445,3906,3960,23026
1988,29,93209,113100,1881722,1862914,14981,13.387,12599,11.258,328626,122700,205926,6.586,17.64,290596,108866,181730,5.844,15.599,38030,2.041,31.198,8700,8842,52080
1988,30,19094,21929,206352,206364,2829,12.936,2709,12.387,38547,15045,23502,7.291,18.679,38675,15719,22956,7.617,18.741,-128,-0.062,37.358,1866,1882,9007
1988,31,33002,38928,541235,530137,4412,11.44,3689,9.565,93334,32993,60341,6.223,17.606,71441,27652,43789,5.216,13.476,21893,4.13,26.952,2565,2601,14150
1988,32,21073,24685,466587,456713,4312,17.898,3127,12.979,111073,40207,70866,8.804,24.32,92061,40256,51805,8.814,20.157,19012,4.163,40.315,2151,2174,17229
1988,33,26843,30490,467325,457633,4945,16.596,3559,11.944,91437,35428,56009,7.742,19.98,71948,26956,44992,5.89,15.722,19489,4.259,31.444,2618,2640,15854
1988,34,162890,187080,3203959,3180114,25676,13.933,20070,10.891,584890,211625,373265,6.655,18.392,538973,177198,361775,5.572,16.948,45917,1.444,33.896,14386,14545,86861
1988,35,26563,31430,398907,395704,4632,14.83,4241,13.578,81651,32137,49514,8.121,20.634,75111,30493,44618,7.706,18.982,6540,1.653,37.963,2911,2964,18602
1988,36,352965,403309,6909186,6872402,52884,13.233,45569,11.402,1213032,389505,823527,5.668,17.651,1135480,373946,761534,5.441,16.522,77552,1.128,33.045,33703,34083,196389
1988,37,115456,143151,2555081,2497889,20066,14.267,15049,10.7,463834,186443,277391,7.464,18.569,348342,127853,220489,5.118,13.945,115492,4.624,27.891,10077,10280,61321
1988,38,14671,17035,188113,185248,1916,11.312,1721,10.161,31343,12096,19247,6.53,16.919,25564,9930,15634,5.36,13.8,5779,3.12,27.6,1120,1134,5002
1988,39,173437,218990,4039691,3973281,26222,12.107,21417,9.888,705535,277396,428139,6.982,17.757,573552,214429,359123,5.397,14.435,131983,3.322,28.87,13874,14354,103797
1988,40,55562,66994,892379,884252,8869,13.206,9198,13.696,173981,68582,105399,7.756,19.676,158112,67708,90404,7.657,17.881,15869,1.795,35.762,6460,6658,38399
1988,41,58606,69244,939526,915580,9876,14.419,8377,12.23,197466,72007,125459,7.865,21.567,149093,64045,85048,6.995,16.284,48373,5.283,32.568,5846,5974,35761
1988,42,201543,245709,4396083,4340474,30070,12.408,23352,9.636,743818,265389,478429,6.114,17.137,632480,236376,396104,5.446,14.572,111338,2.565,29.143,15934,16310,121646
1988,44,21973,24405,405566,401412,3384,14.08,2643,10.997,70693,25654,45039,6.391,17.611,61722,23389,38333,5.827,15.376,8971,2.235,30.752,1875,1893,11578
1988,45,56654,69498,1194466,1167031,9896,14.48,7581,11.093,240301,99525,140776,8.528,20.591,183717,83323,100394,7.14,15.742,56584,4.849,31.485,5265,5373,32978
1988,46,15325,17538,201630,198507,2020,11.615,1727,9.93,34435,13781,20654,6.942,17.347,28108,11492,16616,5.789,14.16,6327,3.187,28.319,1176,1201,6263
1988,47,80537,99480,1784143,1744098,14280,14.576,11253,11.487,359115,154637,204478,8.866,20.59,279378,112530,166848,6.452,16.018,79737,4.572,32.037,7597,7730,52100
1988,48,275570,351315,5512158,5491023,50755,14.42,52096,14.801,1133811,462953,670858,8.431,20.648,1093692,453387,640305,8.257,19.918,40119,0.731,39.836,35764,36837,228219
1988,49,26370,31875,517748,510398,4847,15.309,4420,13.96,109963,49934,60029,9.783,21.545,95240,42601,52639,8.347,18.66,14723,2.885,37.32,3005,3159,24846
1988,50,15211,16949,213238,210106,2523,15.234,1748,10.555,39706,17699,22007,8.424,18.898,33612,12452,21160,5.927,15.998,6094,2.9,31.995,1274,1287,7313
1988,51,102419,128273,2221390,2169439,18783,14.96,13354,10.636,428830,171846,256984,7.921,19.767,325993,120110,205883,5.536,15.027,102837,4.74,30.053,8990,9169,56739
1988,53,91551,109042,1528092,1494403,16212,15.08,13144,12.226,325855,113707,212148,7.609,21.805,258291,105602,152689,7.067,17.284,67564,4.521,34.568,8673,8884,51698
1988,54,28035,33571,466493,462773,4302,12.966,3517,10.6,83141,35310,47831,7.63,17.966,75786,29409,46377,6.355,16.377,7355,1.589,32.753,2391,2435,14216
1988,55,89508,106551,1837638,1797107,12158,11.534,9869,9.363,308126,110298,197828,6.138,17.146,227548,84912,142636,4.725,12.662,80578,4.484,25.324,6789,6906,42504
1988,56,11135,12792,123066,123480,1656,12.961,1625,12.719,23017,8821,14196,7.144,18.64,23863,10196,13667,8.257,19.325,-846,-0.685,37.281,1060,1073,5457
1989,01,63455,78486,1310261,1274590,10569,13.627,8720,11.243,245580,96199,149381,7.547,19.267,174986,60802,114184,4.77,13.729,70594,5.539,27.458,6195,6331,36616
1989,02,10322,12298,145224,141303,1923,15.898,1518,12.55,31953,11844,20109,8.382,22.613,24163,8953,15210,6.336,17.1,7790,5.513,34.2,1039,1062,5401
1989,04,62659,77675,1237990,1220187,12257,15.907,11019,14.3,261708,110392,151316,9.047,21.448,225967,89382,136585,7.325,18.519,35741,2.929,37.038,7675,7853,52727
1989,05,40531,47925,727247,715861,6030,12.675,5325,11.193,124979,48937,76042,6.836,17.459,102453,41168,61285,5.751,14.312,22526,3.147,28.624,3935,4013,25278
1989,06,528694,644103,10864181,10654235,94828,14.916,78079,12.282,2195630,807244,1388386,7.577,20.608,1780802,645720,1135082,6.061,16.714,414828,3.894,33.429,54435,55788,368031
1989,08,70850,84782,1233637,1223724,12092,14.311,11522,13.636,233128,88662,144466,7.245,19.051,213940,96558,117382,7.891,17.483,19188,1.568,34.965,8003,8233,52480
1989,09,73017,84577,1537441,1531205,10762,12.841,9231,11.014,244134,90086,154048,5.883,15.944,232255,86223,146032,5.631,15.168,11879,0.776,30.336,6675,6757,39677
1989,10,13598,15937,306324,302352,2306,14.809,1576,10.121,52665,19409,33256,6.419,17.418,44648,13383,31265,4.426,14.767,8017,2.652,29.534,1067,1093,7343
1989,11,14514,17430,393891,390048,2220,12.839,1942,11.231,67141,21261,45880,5.451,17.214,59860,22653,37207,5.808,15.347,7281,1.867,30.694,1294,1302,10518
1989,12,258608,315164,4551470,4452511,50929,16.404,41537,13.379,972571,392208,580363,8.809,21.843,779191,317332,461859,7.127,17.5,193380,4.343,35.0,30127,30845,200617
1989,13,111736,140446,2514930,2476598,20747,14.984,16775,12.115,501942,201228,300714,8.125,20.267,428540,154878,273662,6.254,17.304,73402,2.964,34.607,11561,11837,80150
1989,15,20948,25832,410644,397874,3334,13.09,2608,10.24,77126,30535,46591,7.675,19.385,51498,18844,32654,4.736,12.943,25628,6.441,25.887,1869,1899,12142
1989,16,19394,22913,292543,281138,2988,13.179,2506,11.053,61797,24213,37584,8.612,21.981,38848,14846,24002,5.281,13.818,22949,8.163,27.636,1716,1759,9767
1989,17,199084,240195,4525841,4457001,29072,12.233,23982,10.091,752606,281632,470974,6.319,16.886,615474,214091,401383,4.803,13.809,137132,3.077,27.618,16414,16868,108289
1989,18,93399,115451,2115796,2067832,13678,11.991,10911,9.565,352694,125158,227536,6.053,17.056,257496,96798,160698,4.681,12.452,95198,4.604,24.905,7720,7922,51860
1989,19,54386,66005,991692,963613,6706,10.22,5925,9.03,165879,63585,102294,6.599,17.214,110926,40811,70115,4.235,11.511,54953,5.703,23.023,4203,4293,24812
1989,20,50154,60131,867977,845068,6955,11.602,6587,10.988,168267,76804,91463,9.088,19.912,121639,47578,74061,5.63,14.394,46628,5.518,28.788,4773,4874,27005
1989,21,59050,71320,1151725,1129001,9061,12.851,7441,10.553,200710,72508,128202,6.422,17.778,156217,60419,95798,5.352,13.837,44493,3.941,27.674,5363,5466,31507
1989,22,65311,80409,1223255,1208617,9376,11.611,10054,12.451,226489,80781,145708,6.684,18.74,198076,78716,119360,6.513,16.389,28413,2.351,32.777,7007,7202,47778
1989,23,26860,30959,434493,428246,4440,14.583,3414,11.213,79321,28986,50335,6.769,18.522,66752,23951,42801,5.593,15.587,12569,2.935,31.175,2556,2609,14281
1989,24,82593,101264,1808392,1788753,13854,13.917,10419,10.466,324161,124823,199338,6.978,18.122,285525,99825,185700,5.581,15.962,38636,2.16,31.924,7177,7308,52651
1989,25,123491,146100,2893243,2868043,18041,12.462,15378,10.622,490829,176885,313944,6.167,17.114,443260,142375,300885,4.964,15.455,47569,1.659,30.91,11319,11493,79180
1989,26,151081,185120,3343133,3285450,22985,12.604,17478,9.584,551223,179736,371487,5.471,16.778,436295,147727,288568,4.496,13.28,114928,3.498,26.559,12350,12746,76837
1989,27,81160,98054,1790644,1759047,11768,12.137,9575,9.875,300404,110661,189743,6.291,17.078,239068,95203,143865,5.412,13.591,61336,3.487,27.182,6581,6754,46089
1989,28,39503,47894,720254,711848,6118,12.871,5394,11.348,119521,45374,74147,6.374,16.79,102841,38540,64301,5.414,14.447,16680,2.343,28.894,3803,3870,22052
1989,29,95205,115872,1945121,1913181,14855,12.971,12157,10.615,337343,112018,225325,5.855,17.633,275262,98905,176357,5.17,14.388,62081,3.245,28.775,8602,8834,57360
1989,30,19127,22019,215118,210787,2632,11.975,2554,11.62,39430,14526,24904,6.891,18.706,30827,12035,18792,5.71,14.625,8603,4.081,29.25,1794,1809,7909
1989,31,33324,39509,567059,554054,4382,11.172,3812,9.719,97606,36755,60851,6.634,17.617,71710,28660,43050,5.173,12.943,25896,4.674,25.886,2637,2707,15923
1989,32,22262,26099,509647,487826,4396,17.31,2989,11.77,121540,41501,80039,8.507,24.915,78385,32042,46343,6.568,16.068,43155,8.846,32.136,2076,2120,18330
1989,33,27132,30984,473668,470741,4344,14.13,3862,12.562,78387,30313,48074,6.439,16.652,72837,25030,47807,5.317,15.473,5550,1.179,30.946,3002,3036,16985
1989,34,165044,190315,3265655,3238717,24234,12.841,21065,11.161,575574,204318,371256,6.309,17.772,521417,168009,353408,5.188,16.099,54157,1.672,32.199,15348,15574,89092
1989,35,26896,32038,407258,403102,4573,14.405,3988,12.562,77884,31039,46845,7.7,19.321,69434,26426,43008,6.556,17.225,8450,2.096,34.45,2816,2875,16125
1989,36,357227,409800,6988402,6953716,52724,12.967,46342,11.397,1144408,402183,742225,5.784,16.458,1077066,370378,706688,5.326,15.489,67342,0.968,30.978,34597,35205,206049
1989,37,118666,147373,2634701,2595542,19415,13.362,15270,10.509,442525,168595,273930,6.496,17.049,366893,128724,238169,4.959,14.136,75632,2.914,28.271,10325,10574,61137
1989,38,14738,17174,191653,189497,1758,10.276,1624,9.493,29287,11636,17651,6.14,15.455,25198,9285,15913,4.9,13.297,4089,2.158,26.595,1166,1175,5125
1989,39,176482,223823,4189442,4121505,25812,11.655,21108,9.531,711145,263648,447497,6.397,17.254,574011,223084,350927,5.413,13.927,137134,3.327,27.854,14201,14739,100615
1989,40,55686,67335,920326,906656,8587,12.783,8268,12.308,167179,62738,104441,6.92,18.439,140297,56489,83808,6.23,15.474,26882,2.965,30.948,5914,6026,32914
1989,41,60118,71265,978110,958743,9828,13.986,7834,11.149,192092,68771,123321,7.173,20.036,152305,62668,89637,6.536,15.886,39787,4.15,31.772,5609,5749,32283
1989,42,206048,251756,4506901,4453817,29056,11.679,23127,9.296,711907,242269,469638,5.44,15.984,606791,224037,382754,5.03,13.624,105116,2.36,27.248,16100,16538,111401
1989,44,22400,25016,402899,404235,3290,13.306,2709,10.956,64853,25671,39182,6.351,16.043,67765,25941,41824,6.417,16.764,-2912,-0.72,32.087,2097,2115,16233
1989,45,57996,71393,1235402,1213300,9489,13.467,7625,10.822,211505,78399,133106,6.462,17.432,167938,61527,106411,5.071,13.841,43567,3.591,27.683,5317,5409,31541
1989,46,15537,17840,209117,205033,1929,10.906,1625,9.187,33736,9501,24235,4.634,16.454,25556,9805,15751,4.782,12.464,8180,3.99,24.929,1173,1185,5259
1989,47,82280,102363,1856017,1820140,13966,13.836,11117,11.014,344074,128635,215439,7.067,18.904,270998,104983,166015,5.768,14.889,73076,4.015,29.778,7744,7982,57299
1989,48,275463,352557,5695716,5598025,48677,13.829,47545,13.507,1168119,467750,700369,8.356,20.867,977109,407524,569585,7.28,17.455,191010,3.412,34.909,32802,34156,234929
1989,49,26571,32234,543736,530251,4540,14.16,4196,13.087,116830,45576,71254,8.595,22.033,90356,38284,52072,7.22,17.04,26474,4.993,34.08,2881,2956,20336
1989,50,15778,17611,220952,217080,2484,14.368,1838,10.632,35834,13022,22812,5.999,16.507,28164,11871,16293,5.469,12.974,7670,3.533,25.948,1419,1436,7398
1989,51,105513,133126,2313074,2270339,18756,14.348,13947,10.669,417663,165424,252239,7.286,18.397,332826,122122,210704,5.379,14.66,84837,3.737,29.32,9684,9954,58151
1989,53,94082,112550,1632388,1584413,16255,14.668,12792,11.543,337645,124030,213615,7.828,21.31,240625,85732,154893,5.411,15.187,97020,6.123,30.374,8850,8999,52782
1989,54,28351,34074,475677,471430,3961,11.708,3477,10.277,75510,30259,45251,6.419,16.017,66988,24308,42680,5.156,14.21,8522,1.808,28.419,2481,2526,14461
1989,55,91044,108992,1912643,1873901,12203,11.322,9791,9.084,301110,97392,203718,5.197,16.069,223687,77884,145803,4.156,11.937,77423,4.132,23.874,6852,7051,39426
1989,56,11157,12847,127210,125508,1594,12.433,1542,12.027,23761,8684,15077,6.919,18.932,20386,7751,12635,6.176,16.243,3375,2.689,32.486,1043,1055,4747
1990,01,64353,79833,1359579,1338257,10044,12.688,8701,10.991,229688,78538,151150,5.869,17.163,187062,63326,123736,4.732,13.978,42626,3.185,27.956,6332,6474,39850
1990,02,10611,12675,158190,151878,1887,15.114,1508,12.078,35837,10895,24942,7.174,23.596,23230,9577,13653,6.306,15.295,12607,8.301,30.59,1044,1079,6713
1990,04,63530,78594,1257186,1247521,11730,15.012,10820,13.847,246170,98451,147719,7.892,19.733,227491,82251,145240,6.593,18.235,18679,1.497,36.471,7477,7696,48395
1990,05,41346,48939,750127,737426,6145,12.687,5139,10.61,123743,44447,79296,6.027,16.78,97921,32215,65706,4.369,13.279,25822,3.502,26.558,3797,3856,20853
1990,06,542239,661394,11307110,11106786,94646,14.499,77439,11.863,2215469,810581,1404888,7.298,19.947,1817061,661302,1155759,5.954,16.36,398408,3.587,32.72,55141,56456,387153
1990,08,72365,86533,1277109,1255662,12037,14.052,10287,12.009,235732,92293,143439,7.35,18.774,192997,76477,116520,6.091,15.37,42735,3.403,30.74,7258,7425,45145
1990,09,72325,84277,1506799,1523354,9380,11.11,9681,11.467,211098,77883,133215,5.113,13.857,244786,87797,156989,5.763,16.069,-33688,-2.211,27.715,7093,7211,41905
1990,10,14104,16574,315351,311820,2272,13.972,1647,10.128,48691,15407,33284,4.941,15.615,41454,13508,27946,4.332,13.294,7237,2.321,26.588,1146,1156,6751
1990,11,14258,17260,396020,398484,2015,11.617,2186,12.603,57498,20626,36872,5.176,14.429,62970,18446,44524,4.629,15.802,-5472,-1.373,28.858,1515,1535,9709
1990,12,265512,324432,4683766,4630330,51103,15.979,41875,13.093,924166,383137,541029,8.275,19.959,814858,304087,510771,6.567,17.598,109308,2.361,35.197,31303,32078,195244
1990,13,113375,142970,2564850,2542589,19508,13.767,16980,11.983,460295,169867,290428,6.681,18.103,415710,145110,270600,5.707,16.35,44585,1.754,32.7,11891,12205,77300
1990,15,21595,26653,432244,421052,3430,13.07,2612,9.953,77184,30438,46746,7.229,18.331,54104,20909,33195,4.966,12.85,23080,5.482,25.699,1790,1838,11672
1990,16,20443,24064,308004,300329,3388,14.424,2237,9.524,58213,20064,38149,6.681,19.383,43256,14603,28653,4.862,14.403,14957,4.98,28.806,1584,1609,9300
1990,17,203021,245190,4649709,4597946,28101,11.577,23170,9.546,701510,240021,461489,5.22,15.257,597554,194024,403530,4.22,12.996,103956,2.261,25.992,16309,16641,103870
1990,18,95133,117925,2162216,2140239,13367,11.454,10915,9.353,318240,109254,208986,5.105,14.869,273480,86347,187133,4.034,12.778,44760,2.091,25.556,7825,8023,49149
1990,19,55124,67093,1022938,1007475,6682,10.039,5621,8.445,146328,47406,98922,4.705,14.524,115119,35134,79985,3.487,11.426,31209,3.098,22.853,4088,4189,23167
1990,20,50087,60210,895251,881879,6601,10.969,6538,10.864,141255,50500,90755,5.726,16.018,115283,41027,74256,4.652,13.072,25972,2.945,26.145,4729,4834,25462
1990,21,59937,72501,1197621,1176593,8728,12.137,7549,10.498,198288,75341,122947,6.403,16.853,156312,55208,101104,4.692,13.285,41976,3.568,26.57,5490,5582,32195
1990,22,65746,81083,1278585,1250749,9610,11.9,8958,11.093,235111,81286,153825,6.499,18.798,179027,67979,111048,5.435,14.314,56084,4.484,28.627,6347,6504,41953
1990,23,26396,30602,423915,428902,3507,11.392,3872,12.578,61378,25207,36171,5.877,14.311,71466,22182,49284,5.172,16.663,-10088,-2.352,28.621,2956,3000,15605
1990,24,84711,103994,1848185,1828640,13319,12.977,10595,10.323,317371,111704,205667,6.109,17.356,278647,93201,185446,5.097,15.238,38724,2.118,30.476,7391,7562,54376
1990,25,120590,143967,2795011,2851000,15383,10.605,17550,12.099,385524,150832,234692,5.29,13.522,496938,153599,343339,5.388,17.43,-111414,-3.908,27.045,12881,13127,83313
1990,26,153932,189009,3396251,3371928,21848,11.678,18006,9.624,524585,196926,327659,5.84,15.557,476066,143322,332744,4.25,14.119,48519,1.439,28.237,12897,13285,81572
1990,27,82910,100030,1834433,1814110,11369,11.478,9409,9.499,280072,91601,188471,5.049,15.439,237432,87445,149987,4.82,13.088,42640,2.35,26.176,6520,6664,44721
1990,28,39978,48522,742378,731251,6022,12.491,5399,11.199,120113,42971,77142,5.876,16.426,98669,35959,62710,4.917,13.493,21444,2.933,26.986,3909,3998,22530
1990,29,96816,117699,1990992,1968170,14086,12.06,12286,10.519,312404,111423,200981,5.661,15.873,266198,87543,178655,4.448,13.525,46206,2.348,27.05,8609,8845,51800
1990,30,19530,22429,223662,219543,2609,11.735,2216,9.967,38570,12303,26267,5.604,17.568,30501,11980,18521,5.457,13.893,8069,3.675,27.786,1559,1575,6383
1990,31,33675,39961,587120,577078,4099,10.315,3652,9.19,86762,29933,56829,5.187,15.035,66529,22906,43623,3.969,11.529,20233,3.506,23.057,2541,2587,14155
1990,32,23353,27369,545480,526716,4454,16.658,3191,11.935,117926,37409,80517,7.102,22.389,80104,29083,51021,5.522,15.208,37822,7.181,30.416,2262,2292,20108
1990,33,26165,30143,454323,463610,3656,11.962,4499,14.72,68253,29982,38271,6.467,14.722,86562,29833,56729,6.435,18.671,-18309,-3.949,29.444,3458,3514,19180
1990,34,165047,191447,3266029,3267710,22820,11.955,21688,11.362,525735,198272,327463,6.068,16.089,529250,163525,365725,5.004,16.196,-3515,-0.108,32.178,15787,15986,91620
1990,35,27487,32674,423859,415538,4466,13.8,3844,11.878,79764,32233,47531,7.757,19.195,62766,25039,37727,6.026,15.105,16998,4.091,30.21,2629,2683,15053
1990,36,356767,411715,7030753,7013096,49241,11.987,47395,11.537,1074549,374803,699746,5.344,15.322,1038323,345153,693170,4.922,14.805,36226,0.517,29.611,35841,36394,204326
1990,37,121688,151296,2712075,2676030,19048,12.755,15134,10.134,434100,154162,279938,5.761,16.222,362718,122316,240402,4.571,13.554,71382,2.667,27.109,10660,10928,64567
1990,38,14755,17217,196998,194373,1662,9.663,1626,9.454,28084,8552,19532,4.4,14.449,22791,8670,14121,4.461,11.725,5293,2.723,23.451,1184,1197,5123
1990,39,178250,226835,4261530,4230785,24106,10.698,21108,9.367,611894,215339,396555,5.09,14.463,551243,174067,377176,4.114,13.029,60651,1.434,26.059,14632,15022,99208
1990,40,56347,68038,940237,930347,8390,12.395,7686,11.355,158858,56292,102566,6.051,17.075,139288,52140,87148,5.604,14.972,19570,2.104,29.943,5512,5639,30625
1990,41,61267,72673,1018015,997845,9505,13.207,8103,11.259,186747,64897,121850,6.504,18.715,146252,55167,91085,5.529,14.657,40495,4.058,29.314,5744,5874,34802
1990,42,209352,256355,4609264,4563916,27537,10.838,22995,9.05,666284,214821,451463,4.707,14.599,575135,176616,398519,3.87,12.602,91149,1.997,25.204,16399,16791,103790
1990,44,22166,24840,392014,397611,2758,11.066,2926,11.74,53781,21830,31951,5.49,13.526,65411,20128,45283,5.062,16.451,-11630,-2.925,27.052,2250,2267,12338
1990,45,59364,73203,1285104,1260182,9601,13.279,7804,10.793,218894,83737,135157,6.645,17.37,168476,61300,107176,4.864,13.369,50418,4.001,26.738,5576,5719,34063
1990,46,15945,18282,220213,214612,2100,11.624,1668,9.233,37601,13431,24170,6.258,17.52,26544,10737,15807,5.003,12.368,11057,5.152,24.737,1193,1208,5117
1990,47,83311,103976,1890538,1871778,12848,12.452,11259,10.912,306888,116230,190658,6.21,16.396,269345,95091,174254,5.08,14.39,37543,2.006,28.78,8007,8163,50828
1990,48,279815,358313,5896720,5800681,49193,13.839,43477,12.231,1149747,447239,702508,7.71,19.821,953108,390148,562960,6.726,16.431,196639,3.39,32.862,30215,31295,216616
1990,49,27103,32885,572685,558767,4331,13.301,3686,11.32,108302,38189,70113,6.835,19.382,80902,30662,50240,5.487,14.479,27400,4.904,28.957,2541,2611,17182
1990,50,15792,17675,215676,217946,2066,11.707,2012,11.401,30190,10320,19870,4.735,13.852,34773,11157,23616,5.119,15.955,-4583,-2.103,27.704,1555,1567,7118
1990,51,108052,136902,2367239,2339923,18027,13.352,14248,10.553,397215,150490,246725,6.431,16.976,343877,110403,233474,4.718,14.696,53338,2.279,29.392,9958,10184,59892
1990,53,98098,117101,1724885,1678618,16928,14.741,12397,10.795,335143,108642,226501,6.472,19.965,244552,102345,142207,6.097,14.569,90591,5.397,29.137,8595,8806,51574
1990,54,28644,34502,491761,484066,3960,11.548,3542,10.329,77451,27821,49630,5.747,16.0,62416,22652,39764,4.68,12.894,15035,3.106,25.788,2574,2620,14007
1990,55,92893,111274,1970452,1942741,11650,10.576,9405,8.538,279098,95342,183756,4.908,14.366,223801,77464,146337,3.987,11.52,55297,2.846,23.04,6657,6851,39572
1990,56,11296,12985,133423,130408,1547,11.98,1404,10.872,25213,8240,16973,6.319,19.334,19165,7672,11493,5.883,14.696,6048,4.638,29.392,957,978,4566
1991,01,64107,80376,1354101,1359655,9843,12.294,9221,11.517,217616,91482,126134,6.728,16.005,228136,87189,140947,6.413,16.779,-10520,-0.774,32.01,6321,6489,50581
1991,02,10812,13082,162330,160916,1933,15.015,1517,11.783,33312,12334,20978,7.665,20.702,30432,9327,21105,5.796,18.912,2880,1.79,37.824,982,1004,5823
1991,04,64069,80012,1257331,1256764,11932,15.054,10427,13.156,244654,115980,128674,9.228,19.467,243608,93670,149938,7.453,19.384,1046,0.083,38.768,7181,7386,56086
1991,05,41221,49360,760633,758091,6016,12.246,5550,11.297,120631,47218,73413,6.229,15.912,116187,38791,77396,5.117,15.326,4444,0.586,30.653,3956,4006,23818
1991,06,539766,666830,10917482,11122511,92346,13.915,85980,12.956,1906280,754441,1151839,6.783,17.139,2314021,798153,1515868,7.176,20.805,-407741,-3.666,34.278,60296,61772,494723
1991,08,73766,88775,1288910,1283201,12671,14.465,10311,11.771,228398,90117,138281,7.023,17.799,217133,83145,133988,6.48,16.921,11265,0.878,33.842,7136,7305,49609
1991,09,69664,82104,1430818,1466588,8449,10.161,10543,12.679,193693,72216,121477,4.924,13.207,265359,84548,180811,5.765,18.094,-71666,-4.887,26.414,7481,7614,47990
1991,10,14256,17024,314981,315437,2314,13.775,1862,11.085,48517,19482,29035,6.176,15.381,49977,14991,34986,4.752,15.844,-1460,-0.463,30.762,1248,1284,7169
1991,11,14191,17203,384236,392714,2107,12.235,2143,12.444,51307,19379,31928,4.935,13.065,68573,21089,47484,5.37,17.461,-17266,-4.397,26.129,1286,1327,11856
1991,12,265034,327008,4602483,4643652,49447,15.188,46556,14.3,871881,391837,480044,8.438,18.776,952746,359069,593677,7.732,20.517,-80865,-1.741,37.552,33238,34129,225405
1991,13,112777,143786,2474668,2520944,19348,13.502,18363,12.815,408680,174280,234400,6.913,16.211,498918,190481,308437,7.556,19.791,-90238,-3.58,32.423,12409,12743,111404
1991,15,21903,27446,435174,433382,3608,13.34,2807,10.379,75555,31860,43695,7.351,17.434,72141,24043,48098,5.548,16.646,3414,0.788,33.292,1933,1984,14899
1991,16,20778,24633,311442,309546,3133,12.877,2526,10.382,56774,21115,35659,6.821,18.341,52693,20922,31771,6.759,17.023,4081,1.318,34.045,1717,1739,10248
1991,17,202795,247459,4592070,4619423,28037,11.387,25569,10.384,660795,256786,404009,5.559,14.305,716821,240407,476414,5.204,15.518,-56026,-1.213,28.609,17701,18111,141679
1991,18,95151,119442,2115591,2134622,13398,11.295,11752,9.907,295080,117907,177173,5.524,13.824,334568,105185,229383,4.928,15.673,-39488,-1.85,27.647,8279,8479,64690
1991,19,55211,67991,1026619,1025124,6768,10.028,5767,8.545,136929,46140,90789,4.501,13.357,133462,42265,91197,4.123,13.019,3467,0.338,26.038,4055,4135,24195
1991,20,49675,60380,887558,891056,7001,11.62,6735,11.179,134425,54366,80059,6.101,15.086,141342,50424,90918,5.659,15.862,-6917,-0.776,30.172,4647,4813,30847
1991,21,59476,73133,1191455,1196205,8573,11.78,7864,10.805,186576,76853,109723,6.425,15.597,196305,66810,129495,5.585,16.411,-9729,-0.813,31.195,5735,5833,38772
1991,22,65754,82087,1302077,1291604,9949,12.201,8861,10.867,236726,90149,146577,6.98,18.328,216638,81659,134979,6.322,16.773,20088,1.555,33.546,6191,6364,47287
1991,23,25575,30108,401909,412927,3375,11.122,3850,12.687,52898,22038,30860,5.337,12.811,74804,25267,49537,6.119,18.116,-21906,-5.305,25.621,2731,2761,15120
1991,24,83728,104210,1740763,1795140,12709,12.213,12403,11.919,253964,107904,146060,6.011,14.147,362532,124106,238426,6.913,20.195,-108568,-6.048,28.295,8516,8665,65910
1991,25,115160,139494,2592517,2695742,14424,10.182,18766,13.247,329618,129275,200343,4.796,12.227,535629,186618,349011,6.923,19.869,-206011,-7.642,24.455,12718,13126,107765
1991,26,153824,190674,3261089,3336217,21381,11.269,19507,10.281,442651,171014,271637,5.126,13.268,593815,194767,399048,5.838,17.799,-151164,-4.531,26.536,13666,14039,105516
1991,27,83518,101959,1801835,1815800,12083,11.975,9976,9.886,262496,104572,157924,5.759,14.456,290847,97999,192848,5.397,16.018,-28351,-1.561,28.912,6895,7101,57873
1991,28,39798,48835,746991,744990,5975,12.282,5602,11.515,118106,47242,70864,6.341,15.853,114322,38326,75996,5.145,15.345,3784,0.508,30.691,3898,3955,22994
1991,29,96147,118353,1940783,1958942,14166,12.012,13325,11.299,282106,113491,168615,5.793,14.401,318850,111490,207360,5.691,16.277,-36744,-1.876,28.802,9247,9522,65197
1991,30,19646,22804,224813,223852,2718,12.033,2287,10.125,36918,14546,22372,6.498,16.492,34868,11410,23458,5.097,15.576,2050,0.916,31.153,1642,1674,7974
1991,31,33654,40473,591946,590055,4288,10.671,3712,9.237,86455,32884,53571,5.573,14.652,83384,27820,55564,4.715,14.132,3071,0.52,28.263,2623,2683,19390
1991,32,24047,28592,541047,538743,4644,16.606,3390,12.122,102517,41692,60825,7.739,19.029,96801,29607,67194,5.496,17.968,5716,1.061,35.936,2372,2411,19488
1991,33,24928,29154,427799,444933,3439,11.61,4373,14.763,56550,25644,30906,5.764,12.71,90731,35089,55642,7.886,20.392,-34181,-7.682,25.42,3151,3204,20336
1991,34,160779,188234,3085719,3168658,21347,11.251,24334,12.826,450782,169101,281681,5.337,14.226,615994,193506,422488,6.107,19.44,-165212,-5.214,28.453,16864,17129,110210
1991,35,27704,33194,431308,428113,4575,13.905,3991,12.13,82153,34682,47471,8.101,19.19,75946,31275,44671,7.305,17.74,6207,1.45,35.479,2710,2781,17682
1991,36,349957,408263,6703630,6875829,47401,11.566,50506,12.324,928777,373971,554806,5.439,13.508,1275529,413269,862260,6.01,18.551,-346752,-5.043,27.016,37316,37928,259654
1991,37,120576,151846,2597736,2651007,18062,11.925,17303,11.424,355823,149581,206242,5.642,13.422,464067,151687,312380,5.722,17.505,-108244,-4.083,26.844,12047,12368,83827
1991,38,14638,17275,201904,199284,1769,10.266,1683,9.767,32263,13594,18669,6.821,16.189,27106,9194,17912,4.614,13.602,5157,2.588,27.203,1166,1190,5943
1991,39,177565,228328,4140276,4213765,23932,10.521,22202,9.761,544843,206617,338226,4.903,12.93,695877,224460,471417,5.327,16.514,-151034,-3.584,25.86,15096,15414,132800
1991,40,56805,69080,953634,946217,8715,12.722,7565,11.043,160985,67806,93179,7.166,17.014,145321,56910,88411,6.014,15.358,15664,1.655,30.716,5305,5439,34478
1991,41,61708,74031,1024777,1021574,9986,13.622,8540,11.649,184991,72157,112834,7.063,18.108,177709,67519,110190,6.609,17.396,7282,0.713,34.791,5883,6083,40826
1991,42,207674,256854,4512497,4563290,26206,10.219,25384,9.898,613583,227867,385716,4.993,13.446,716658,243204,473454,5.33,15.705,-103075,-2.259,26.892,17747,18277,137602
1991,44,21262,23993,369506,380615,2455,10.06,3277,13.428,50197,21696,28501,5.7,13.188,72513,23779,48734,6.248,19.052,-22316,-5.863,26.377,2302,2337,15532
1991,45,59449,74303,1258182,1275152,9690,13.146,8509,11.543,192190,84471,107719,6.624,15.072,225970,75795,150175,5.944,17.721,-33780,-2.649,30.144,5857,6043,45482
1991,46,16106,18720,226931,222939,2144,11.598,1677,9.071,37216,14403,22813,6.461,16.693,29297,10036,19261,4.502,13.141,7919,3.552,26.283,1207,1219,6394
1991,47,82728,104683,1851159,1871341,12801,12.279,11931,11.445,282678,114779,167899,6.134,15.106,322610,111088,211522,5.936,17.24,-39932,-2.134,30.211,8286,8470,65361
1991,48,281425,363742,5963190,5927629,50113,13.891,44135,12.234,1140643,466776,673867,7.875,19.243,1071828,437545,634283,7.381,18.082,68815,1.161,36.164,29984,31028,248306
1991,49,27730,33871,597387,584831,4733,14.189,3703,11.101,116603,41847,74756,7.155,19.938,92170,33196,58974,5.676,15.76,24433,4.178,31.52,2522,2599,21841
1991,50,15427,17445,205111,210218,1850,10.537,2075,11.818,26900,11598,15302,5.517,12.796,37248,11935,25313,5.677,17.719,-10348,-4.923,25.592,1540,1548,8290
1991,51,106512,136800,2255581,2308756,16683,12.198,16615,12.148,333434,145409,188025,6.298,14.442,440170,139166,301004,6.028,19.065,-106736,-4.623,28.884,11196,11578,76733
1991,53,99903,120653,1740830,1734687,17058,14.356,13391,11.27,327444,125099,202345,7.212,18.876,314562,106659,207903,6.149,18.134,12882,0.743,36.267,9110,9295,59318
1991,54,28523,34747,486754,488642,3885,11.228,3595,10.39,70858,28864,41994,5.907,14.501,74485,23914,50571,4.894,15.243,-3627,-0.742,29.002,2477,2518,14630
1991,55,93081,112980,1956417,1962911,11986,10.698,10110,9.023,258541,93899,164642,4.784,13.171,271449,90440,181009,4.607,13.829,-12908,-0.658,26.343,7077,7273,58606
1991,56,11486,13336,137230,135853,1668,12.677,1312,9.971,23937,8325,15612,6.128,17.62,20964,7335,13629,5.399,15.431,2973,2.188,30.863,929,937,5220
1992,01,64694,81155,1375540,1368678,9487,11.75,8652,10.716,223218,78804,144414,5.758,16.309,208103,70963,137140,5.185,15.205,15115,1.104,30.409,5788,5925,37823
1992,02,10993,13381,164547,165847,1833,13.872,1499,11.344,34882,11167,23715,6.733,21.033,36903,9546,27357,5.756,22.251,-2021,-1.219,42.065,925,943,5331
1992,04,64920,80847,1270474,1262800,11246,13.99,10324,12.843,245164,94587,150577,7.49,19.414,230015,83294,146721,6.596,18.215,15149,1.2,36.429,6513,6700,43129
1992,05,41660,50010,782309,777151,6017,12.117,5310,10.693,130645,44464,86181,5.721,16.811,120201,38884,81317,5.003,15.467,10444,1.344,30.934,3595,3670,22277
1992,06,531944,659480,10467096,10685453,82490,12.445,89157,13.451,1828750,662517,1166233,6.2,17.114,2264131,834487,1429644,7.81,21.189,-435381,-4.075,34.229,58991,60473,450905
1992,08,75447,90618,1331597,1308648,12468,13.911,10480,11.693,254435,97995,156440,7.488,19.443,207630,83087,124543,6.349,15.866,46805,3.577,31.732,6768,6915,44175
1992,09,67986,80383,1405946,1416952,7969,9.814,9609,11.833,200896,64526,136370,4.554,14.178,222847,70024,152823,4.942,15.727,-21951,-1.549,28.356,6304,6445,36245
1992,10,14246,17121,306698,309907,2196,12.872,2075,12.163,46644,18989,27655,6.127,15.051,53060,18377,34683,5.93,17.121,-6416,-2.07,30.102,1259,1269,7367
1992,11,14032,17078,392934,387243,1829,10.683,1914,11.18,65229,36184,29045,9.344,16.844,55462,16073,39389,4.151,14.322,9767,2.522,28.645,1124,1135,7893
1992,12,268791,330680,4602739,4595428,48614,14.788,44730,13.607,894048,367852,526196,8.005,19.455,879549,360339,519210,7.841,19.14,14499,0.316,38.279,30455,31266,198300
1992,13,114429,145402,2519020,2499209,19237,13.309,17512,12.116,458082,171316,286766,6.855,18.329,418490,162698,255792,6.51,16.745,39592,1.584,33.49,11006,11409,78866
1992,15,21774,27499,440104,437284,3039,11.077,2909,10.604,71443,24277,47166,5.552,16.338,65490,21386,44104,4.891,14.977,5953,1.361,29.953,1885,1917,12383
1992,16,21457,25404,325362,317846,3303,13.211,2498,9.991,60785,21437,39348,6.744,19.124,45754,14897,30857,4.687,14.395,15031,4.729,28.79,1619,1655,8389
1992,17,203194,248712,4557198,4566279,26990,10.889,25301,10.207,693226,234951,458275,5.145,15.181,710836,238767,472069,5.229,15.567,-17610,-0.386,30.363,16313,16695,124792
1992,18,95743,120669,2168831,2150979,12861,10.719,11496,9.581,354141,132190,221951,6.146,16.464,320192,102001,218191,4.742,14.886,33949,1.578,29.772,7628,7795,50755
1992,19,55533,68601,1042525,1033662,6621,9.699,5948,8.713,156525,52254,104271,5.055,15.143,137822,46660,91162,4.514,13.333,18703,1.809,26.667,3925,4012,24758
1992,20,49964,60978,897831,892249,6726,11.092,6049,9.975,140751,52911,87840,5.93,15.775,130055,42057,87998,4.714,14.576,10696,1.199,29.152,3976,4044,24702
1992,21,59615,73571,1212540,1203118,8156,11.124,7648,10.431,186668,66982,119686,5.567,15.515,167235,54904,112331,4.563,13.9,19433,1.615,27.8,5239,5334,31531
1992,22,66308,82737,1312891,1303774,9434,11.456,8663,10.52,237371,78873,158498,6.05,18.206,218231,76953,141278,5.902,16.738,19140,1.468,33.477,5578,5723,41024
1992,23,25316,29856,393630,397011,3202,10.688,3409,11.379,57046,20740,36306,5.224,14.369,63909,24023,39886,6.051,16.098,-6863,-1.729,28.738,2224,2265,10980
1992,24,83833,104494,1716387,1732411,12027,11.53,11656,11.175,272214,97597,174617,5.634,15.713,303939,100171,203768,5.782,17.544,-31725,-1.831,31.426,7321,7513,49783
1992,25,112970,137209,2552423,2567306,13666,9.883,15799,11.426,376295,129431,246864,5.042,14.657,404544,135370,269174,5.273,15.758,-28249,-1.1,29.314,10057,10313,68097
1992,26,153515,190772,3300190,3278171,19796,10.386,19444,10.202,510592,152671,357921,4.657,15.576,465364,145638,319726,4.443,14.196,45228,1.38,28.392,12676,12999,77101
1992,27,84232,103052,1844933,1821686,11401,11.131,10153,9.912,290537,94606,195931,5.193,15.949,244307,85272,159035,4.681,13.411,46230,2.538,26.822,6487,6666,43718
1992,28,40024,49031,754935,749457,5470,11.183,5235,10.703,117494,35150,82344,4.69,15.677,106122,34989,71133,4.669,14.16,11372,1.517,28.32,3462,3531,19514
1992,29,96660,118949,1984838,1971079,13464,11.354,12731,10.736,304238,102719,201519,5.211,15.435,277017,91600,185417,4.647,14.054,27221,1.381,28.108,8239,8420,43594
1992,30,20086,23390,237349,230809,2931,12.697,2318,10.042,45357,14668,30689,6.355,19.651,32489,13113,19376,5.681,14.076,12868,5.575,28.152,1529,1560,7076
1992,31,33977,40833,593335,591610,4140,10.187,3757,9.244,80875,25747,55128,4.352,13.67,77469,25665,51804,4.338,13.095,3406,0.576,26.189,2455,2507,13686
1992,32,24408,29140,543754,541825,4364,15.129,3776,13.09,96262,41369,54893,7.635,17.766,92028,30998,61030,5.721,16.985,4234,0.781,33.97,2479,2505,17281
1992,33,24625,29040,422106,420588,3437,11.816,3533,12.146,68507,24758,43749,5.887,16.288,65489,22488,43001,5.347,15.571,3018,0.718,31.142,2407,2450,12670
1992,34,159070,186274,3056238,3069149,19967,10.668,21743,11.617,481013,141621,339392,4.614,15.673,506636,165220,341416,5.383,16.507,-25623,-0.835,31.345,14318,14487,80097
1992,35,27942,33603,442829,437378,4317,12.926,3909,11.704,85605,32119,53486,7.344,19.572,74525,26216,48309,5.994,17.039,11080,2.533,34.078,2511,2582,14165
1992,36,344302,402489,6585936,6641688,43610,10.764,48950,12.082,982913,318846,664067,4.801,14.799,1093221,387052,706169,5.828,16.46,-110308,-1.661,29.598,34279,34746,193541
1992,37,120903,152618,2655106,2626138,16893,11.1,16035,10.536,420881,139535,281346,5.313,16.027,363334,128570,234764,4.896,13.835,57547,2.191,27.671,10362,10577,56290
1992,38,14612,17345,207804,205241,1685,9.736,1610,9.302,31390,10044,21346,4.894,15.294,26373,8538,17835,4.16,12.85,5017,2.444,25.7,1063,1073,4411
1992,39,177232,228334,4127506,4129556,22400,9.816,22113,9.691,585162,195641,389521,4.738,14.17,589297,196222,393075,4.752,14.27,-4135,-0.1,28.34,13911,14325,104295
1992,40,57096,69619,957521,953744,8294,11.967,7665,11.06,160482,57330,103152,6.011,16.827,153608,56538,97070,5.928,16.106,6874,0.721,32.212,5267,5386,31278
1992,41,62745,75267,1029527,1025222,9466,12.688,8145,10.917,178506,66969,111537,6.532,17.411,170933,57764,113169,5.634,16.673,7573,0.739,33.346,5306,5399,31820
1992,42,205589,255230,4483445,4505212,24011,9.383,25329,9.898,632009,219825,412184,4.879,14.028,678489,207763,470726,4.612,15.06,-46480,-1.032,28.057,16594,17007,100138
1992,44,20796,23474,358867,363551,2402,10.123,2911,12.268,51453,17816,33637,4.901,14.153,60763,22844,37919,6.284,16.714,-9310,-2.561,28.306,1903,1935,11855
1992,45,59638,74606,1274781,1265852,8757,11.765,8407,11.295,203054,74704,128350,5.901,16.041,184640,60684,123956,4.794,14.586,18414,1.455,29.172,5528,5620,33029
1992,46,16228,18926,238678,233018,2009,10.68,1778,9.452,40273,12997,27276,5.578,17.283,28987,9694,19293,4.16,12.44,11286,4.843,24.88,1178,1189,5801
1992,47,83289,105433,1918238,1884601,12282,11.694,11477,10.927,331596,116298,215298,6.171,17.595,265427,98155,167272,5.208,14.084,66169,3.511,28.168,7341,7512,46720
1992,48,285602,369254,6012937,6000271,49044,13.389,43125,11.773,1140027,448971,691056,7.483,19.0,1115045,401259,713786,6.687,18.583,24982,0.416,37.166,27730,28629,201720
1992,49,28570,34797,619336,608176,4800,13.989,3830,11.162,119420,42921,76499,7.057,19.636,96816,38425,58391,6.318,15.919,22604,3.717,31.838,2473,2530,23313
1992,50,15294,17325,205980,206080,1782,10.255,1886,10.853,30027,10154,19873,4.927,14.571,30164,9729,20435,4.721,14.637,-137,-0.066,29.141,1291,1301,6531
1992,51,107051,137386,2259866,2258993,16027,11.695,15328,11.185,357901,129018,228883,5.711,15.843,357190,118262,238928,5.235,15.812,711,0.031,31.624,9557,9851,53144
1992,53,102578,123850,1791228,1763225,16929,13.856,13581,11.116,348347,124938,223409,7.086,19.756,292353,101983,190370,5.784,16.581,55994,3.176,33.161,8738,8906,50775
1992,54,28595,34862,484736,485169,3675,10.569,3497,10.057,74594,26155,48439,5.391,15.375,75046,26178,48868,5.396,15.468,-452,-0.093,30.75,2215,2262,12148
1992,55,93616,113834,1983195,1967295,11043,9.744,10044,8.862,270212,81256,188956,4.13,13.735,238319,75700,162619,3.848,12.114,31893,1.621,24.228,6578,6687,37930
1992,56,11610,13429,139119,138039,1561,11.671,1453,10.864,24240,7553,16687,5.472,17.56,22079,7407,14672,5.366,15.995,2161,1.566,31.99,855,882,3964
1993,01,66308,82713,1416893,1396090,9626,11.749,8066,9.845,226700,68549,158151,4.91,16.238,184704,65880,118824,4.719,13.23,41996,3.008,26.46,5363,5507,30627
1993,02,11286,13576,165513,164971,1742,12.928,1540,11.429,30244,8812,21432,5.342,18.333,29382,9832,19550,5.96,17.81,862,0.523,35.621,896,933,4552
1993,04,66953,82502,1316478,1293558,11400,13.957,9755,11.943,252932,86802,166130,6.71,19.553,208389,81850,126539,6.328,16.11,44543,3.443,32.22,6191,6362,41778
1993,05,43021,51331,812880,797145,6355,12.542,5033,9.933,131830,43395,88435,5.444,16.538,100655,35290,65365,4.427,12.627,31175,3.911,25.254,3432,3491,18136
1993,06,526427,648868,10431906,10489811,76301,11.664,86865,13.279,1828233,605445,1222788,5.772,17.429,1951597,719322,1232275,6.857,18.605,-123364,-1.176,34.857,55767,57339,351452
1993,08,79369,94181,1396317,1363882,13201,14.286,9643,10.436,262568,88535,174033,6.491,19.252,197645,73040,124605,5.355,14.491,64923,4.76,28.983,6206,6341,33979
1993,09,68268,80454,1380333,1391930,8031,9.987,7954,9.891,198613,59689,138924,4.288,14.269,222823,67130,155693,4.823,16.008,-24210,-1.739,28.538,5213,5312,27120
1993,10,14643,17424,308619,307479,2097,12.136,1808,10.463,46769,15390,31379,5.005,15.21,44419,13833,30586,4.499,14.446,2350,0.764,28.892,1062,1082,5500
1993,11,14077,16959,385285,386178,1756,10.317,1879,11.04,53409,16064,37345,4.16,13.83,55468,19094,36374,4.944,14.363,-2059,-0.533,27.66,994,1019,6262
1993,12,278046,338808,4786254,4698099,50189,14.994,42012,12.551,972779,369271,603508,7.86,20.706,796647,325578,471069,6.93,16.957,176132,3.749,33.914,29024,29836,180942
1993,13,118414,149032,2608913,2563836,19524,13.262,15887,10.792,463597,164564,299033,6.419,18.082,373982,137746,236236,5.373,14.587,89615,3.495,29.174,10233,10520,67606
1993,15,21762,27360,426851,433424,2907,10.599,3043,11.095,60232,21721,38511,5.011,13.897,72549,22304,50245,5.146,16.739,-12317,-2.842,27.794,1950,1993,11015
1993,16,22324,26259,339507,332283,3376,13.07,2517,9.745,59641,20973,38668,6.312,17.949,45397,15729,29668,4.734,13.662,14244,4.287,27.324,1631,1663,9429
1993,17,206931,252064,4621913,4603867,26713,10.669,23367,9.332,698080,232574,465506,5.052,15.163,660775,201213,459562,4.371,14.353,37305,0.81,28.705,15251,15683,93271
1993,18,97893,122695,2216156,2192244,12770,10.496,10713,8.805,329626,100762,228864,4.596,15.036,282955,93097,189858,4.247,12.907,46671,2.129,25.814,7110,7302,43981
1993,19,56191,69088,1050327,1039701,6256,9.089,5741,8.341,142114,43978,98136,4.23,13.669,121519,35423,86096,3.407,11.688,20595,1.981,23.376,3792,3868,18458
1993,20,50951,61861,909893,902365,6570,10.697,5685,9.256,132323,41250,91073,4.571,14.664,117344,37294,80050,4.133,13.004,14979,1.66,26.008,3719,3801,20725
1993,21,60763,74715,1249561,1230520,8349,11.261,7196,9.706,199554,68162,131392,5.539,16.217,161959,57420,104539,4.666,13.162,37595,3.055,26.324,4834,4951,27213
1993,22,67901,84144,1326903,1319525,9326,11.178,7906,9.476,226663,74654,152009,5.658,17.178,212396,69619,142777,5.276,16.096,14267,1.081,32.193,5307,5412,39438
1993,23,25642,30045,408261,400943,3321,11.088,3134,10.464,63918,21681,42237,5.408,15.942,49567,17258,32309,4.304,12.363,14351,3.579,24.725,2013,2067,9142
1993,24,85418,105172,1723476,1720232,12137,11.578,11448,10.921,279466,97285,182181,5.655,16.246,272717,90367,182350,5.253,15.854,6749,0.392,31.707,6881,7101,44673
1993,25,113973,137870,2598978,2573784,14193,10.32,13505,9.82,408259,132093,276166,5.132,15.862,356650,115232,241418,4.477,13.857,51609,2.005,27.714,8656,9035,55239
1993,26,156373,193325,3388486,3346496,20221,10.53,17645,9.188,528014,169968,358046,5.079,15.778,445107,148036,297071,4.424,13.301,82907,2.477,26.601,11631,12054,68179
1993,27,86809,105646,1898927,1869480,11503,11.025,8883,8.514,290556,94003,196553,5.028,15.542,230934,75817,155117,4.056,12.353,59622,3.189,24.706,5738,5966,36467
1993,28,41042,50115,782605,766742,5887,11.876,4802,9.687,133944,48981,84963,6.388,17.469,102481,39859,62622,5.198,13.366,31463,4.103,26.732,3356,3396,23726
1993,29,98685,120725,2003850,1992762,13622,11.368,11834,9.876,299486,99351,200135,4.986,15.029,278039,95850,182189,4.81,13.952,21447,1.076,27.905,7859,8044,47216
1993,30,20503,23818,242929,240145,2729,11.561,2305,9.764,40953,12814,28139,5.336,17.053,35293,11564,23729,4.815,14.697,5660,2.357,29.393,1567,1592,7438
1993,31,34406,41233,611475,602964,3996,9.738,3598,8.768,86149,26278,59871,4.358,14.288,68886,21895,46991,3.631,11.425,17263,2.863,22.849,2405,2481,11784
1993,32,25197,29777,561686,552180,4418,14.997,3781,12.835,99953,35554,64399,6.439,18.102,81070,30931,50139,5.602,14.682,18883,3.42,29.364,2391,2432,16586
1993,33,24874,29259,433177,427377,3352,11.501,3127,10.729,68264,22448,45816,5.253,15.973,56627,18793,37834,4.397,13.25,11637,2.723,26.5,2069,2127,9669
1993,34,161540,188333,3084159,3064741,21208,11.324,19116,10.207,511875,161024,350851,5.254,16.702,475671,151203,324468,4.934,15.521,36204,1.181,31.042,12703,12982,72048
1993,35,28865,34353,457677,449740,4325,12.731,3561,10.482,84440,28219,56221,6.275,18.775,69019,24165,44854,5.373,15.346,15421,3.429,30.693,2305,2348,11956
1993,36,344810,402377,6521716,6546003,44727,11.115,44809,11.135,992414,337252,655162,5.152,15.161,1041742,335609,706133,5.127,15.914,-49328,-0.754,30.321,31294,31910,174682
1993,37,123400,155097,2713644,2683757,17051,11.083,14556,9.461,410452,129109,281343,4.811,15.294,350684,116422,234262,4.338,13.067,59768,2.227,26.134,9563,9782,59059
1993,38,14864,17591,215265,211122,1680,9.618,1432,8.198,31750,10120,21630,4.793,15.039,23574,7065,16509,3.346,11.166,8176,3.873,22.332,959,970,4374
1993,39,180130,230159,4195413,4162630,22391,9.767,20560,8.969,613299,194792,418507,4.68,14.733,547505,177445,370060,4.263,13.153,65794,1.581,26.306,12769,13285,79983
1993,40,58443,70728,972794,965395,8192,11.675,7076,10.084,157796,54198,103598,5.614,16.345,143232,50610,92622,5.242,14.837,14564,1.509,29.673,4718,4803,27989
1993,41,64368,76658,1050721,1039572,9360,12.323,7954,10.472,177921,55668,122253,5.355,17.115,154870,51442,103428,4.948,14.897,23051,2.217,29.795,5117,5203,24043
1993,42,205946,254745,4503563,4493351,23023,9.03,23478,9.208,633703,205827,427876,4.581,14.103,613516,193556,419960,4.308,13.654,20187,0.449,27.308,15288,15717,93962
1993,44,21139,23822,366875,362352,2625,11.101,2276,9.625,55045,18498,36547,5.105,15.191,46240,15603,30637,4.306,12.761,8805,2.43,25.522,1537,1570,8378
1993,45,60970,75952,1309092,1292113,8912,11.838,7573,10.059,198625,67973,130652,5.261,15.372,165278,54958,110320,4.253,12.791,33347,2.581,25.583,5006,5115,26113
1993,46,16575,19223,248526,243383,1958,10.266,1658,8.693,38541,11747,26794,4.827,15.836,28449,9504,18945,3.905,11.689,10092,4.147,23.378,1087,1107,5259
1993,47,85617,107617,1955763,1936589,12565,11.797,10346,9.714,321087,106902,214185,5.52,16.58,281122,101032,180090,5.217,14.516,39965,2.064,29.033,6701,6930,42623
1993,48,293681,375813,6184929,6097202,48353,12.98,41743,11.206,1204297,417992,786305,6.855,19.752,1029557,388218,641339,6.367,16.886,174740,2.866,33.771,26699,27622,182833
1993,49,29864,36026,654858,636714,4911,13.871,3667,10.358,119833,40021,79812,6.286,18.821,83158,33122,50036,5.202,13.06,36675,5.76,26.121,2415,2522,19103
1993,50,15573,17639,209999,207632,1961,11.219,1641,9.388,31983,10981,21002,5.289,15.404,27293,11121,16172,5.356,13.145,4690,2.259,26.29,1165,1191,4919
1993,51,109631,139604,2309299,2284183,15939,11.509,13703,9.895,370189,129351,240838,5.663,16.207,320769,104515,216254,4.576,14.043,49420,2.164,28.086,8581,8861,48100
1993,53,105835,126711,1812622,1802733,16610,13.258,13750,10.975,304115,99198,204917,5.503,16.87,284884,97566,187318,5.412,15.803,19231,1.067,31.606,8823,9093,46112
1993,54,29092,35333,496655,490716,3686,10.503,3210,9.147,78838,25919,52919,5.282,16.066,66915,22938,43977,4.674,13.636,11923,2.43,27.272,2111,2149,11209
1993,55,95709,116002,2042606,2011974,11509,10.015,9337,8.125,289369,89431,199938,4.445,14.382,229022,73833,155189,3.67,11.383,60347,2.999,22.766,6278,6457,36572
1993,56,12002,13951,142218,140670,1854,13.546,1326,9.688,25873,10541,15332,7.493,18.393,22678,7592,15086,5.397,16.121,3195,2.271,32.243,841,859,4058
1994,01,68257,85038,1455809,1439413,10493,12.506,8224,9.802,226548,86027,140521,5.977,15.739,194356,62988,131368,4.376,13.502,32192,2.236,27.005,5715,5855,36193
1994,02,11662,13986,173260,170331,1856,13.463,1456,10.561,33855,12461,21394,7.316,19.876,28100,8827,19273,5.182,16.497,5755,3.379,32.995,919,941,4475
1994,04,69743,86119,1415211,1368113,12814,15.188,9310,11.035,300097,116530,183567,8.518,21.935,204993,79676,125317,5.824,14.984,95104,6.951,29.967,6428,6594,41784
1994,05,44162,52975,837695,826101,6747,12.935,5119,9.814,135916,54321,81595,6.576,16.453,112315,43639,68676,5.283,13.596,23601,2.857,27.192,3665,3753,24661
1994,06,526950,649806,10429560,10420007,81261,12.507,81121,12.485,1814110,706872,1107238,6.784,17.41,1796252,649566,1146686,6.234,17.238,17858,0.171,34.477,53774,55564,362397
1994,08,83440,99076,1462207,1430723,14512,15.009,9735,10.069,270266,102578,167688,7.17,18.89,207896,77247,130649,5.399,14.531,62370,4.359,29.062,6856,6986,42382
1994,09,68689,81100,1373248,1376694,8250,10.208,7695,9.521,194646,64276,130370,4.669,14.139,202148,61692,140456,4.481,14.684,-7502,-0.545,28.277,5299,5406,31159
1994,10,14987,17917,314489,311761,2310,13.073,1815,10.272,50798,20267,30531,6.501,16.294,45131,13537,31594,4.342,14.476,5667,1.818,28.952,1145,1155,6185
1994,11,14251,17199,391730,387804,1853,10.845,1627,9.522,53651,19779,33872,5.1,13.835,45350,14244,31106,3.673,11.694,8301,2.141,23.388,1054,1086,6795
1994,12,284854,347568,4991655,4896136,50664,14.756,42212,12.294,959983,376141,583842,7.682,19.607,766423,300071,466352,6.129,15.654,193560,3.953,31.307,30955,31662,189075
1994,13,122183,154024,2723864,2669553,20902,13.785,16111,10.625,481296,184807,296489,6.923,18.029,372299,145137,227162,5.437,13.946,108997,4.083,27.892,10998,11238,76082
1994,15,21799,27426,424171,426150,2847,10.386,2821,10.291,61123,26546,34577,6.229,14.343,65551,21638,43913,5.078,15.382,-4428,-1.039,28.686,1935,2011,15126
1994,16,23639,27771,363265,351972,3950,14.604,2502,9.251,68245,23795,44450,6.76,19.389,45678,15436,30242,4.386,12.978,22567,6.412,25.955,1713,1749,9918
1994,17,210520,256770,4751319,4693488,27783,10.915,23321,9.162,714732,239774,474958,5.109,15.228,598986,207807,391179,4.428,12.762,115746,2.466,25.524,15922,16269,105425
1994,18,100070,125591,2280340,2252919,13432,10.815,10650,8.575,333382,109562,223820,4.863,14.798,278741,98339,180402,4.365,12.372,54641,2.425,24.745,7359,7649,49791
1994,19,56959,70224,1073895,1064525,6736,9.663,5710,8.191,145413,47021,98392,4.417,13.66,127190,45788,81402,4.301,11.948,18223,1.712,23.896,4016,4127,24758
1994,20,52050,63233,941957,926601,7113,11.366,5813,9.288,145652,51098,94554,5.515,15.719,115159,40258,74901,4.345,12.428,30493,3.291,24.856,4050,4206,22731
1994,21,61862,76233,1286005,1269837,8334,11.033,6940,9.188,194062,67944,126118,5.351,15.282,161500,53836,107664,4.24,12.718,32562,2.564,25.436,4889,4990,30511
1994,22,69433,86208,1377304,1353146,10122,11.878,8138,9.55,238274,86614,151660,6.401,17.609,189227,60045,129182,4.437,13.984,49047,3.625,27.968,5654,5873,37847
1994,23,26084,30641,419496,414283,3546,11.683,2966,9.772,63595,21766,41829,5.254,15.351,53739,18949,34790,4.574,12.972,9856,2.379,25.943,2111,2152,12049
1994,24,86928,107015,1745720,1737387,12367,11.65,10640,10.023,279413,96508,182905,5.555,16.082,262677,91594,171083,5.272,15.119,16736,0.963,30.238,7102,7301,45845
1994,25,115930,140369,2634705,2623488,15152,10.886,12794,9.192,397046,132147,264899,5.037,15.134,374589,126187,248402,4.81,14.278,22457,0.856,28.557,8538,8722,59022
1994,26,159539,197463,3501969,3459114,21252,10.869,17375,8.886,533795,181987,351808,5.261,15.432,448838,155202,293636,4.487,12.976,84957,2.456,25.951,12082,12493,76136
1994,27,89216,108898,1966681,1939960,12104,11.275,9017,8.399,283851,93483,190368,4.819,14.632,230898,77589,153309,4.0,11.902,52953,2.73,23.804,6150,6310,41553
1994,28,41698,51019,828450,806904,6036,11.926,5223,10.32,146045,56290,89755,6.976,18.099,102399,35825,66574,4.44,12.69,43646,5.409,25.381,3796,3880,20103
1994,29,100803,123526,2073269,2042463,14850,12.153,12184,9.971,326514,114053,212461,5.584,15.986,264690,91030,173660,4.457,12.959,61824,3.027,25.919,8543,8760,50645
1994,30,21243,24638,249774,246671,3007,12.397,2243,9.247,40948,15611,25337,6.329,16.6,34598,11062,23536,4.485,14.026,6350,2.574,28.052,1591,1613,7196
1994,31,34965,42037,630500,622076,4287,10.287,3560,8.543,90269,31707,58562,5.097,14.511,73424,27247,46177,4.38,11.803,16845,2.708,23.606,2519,2572,13659
1994,32,26642,31551,625456,598054,5155,16.803,3411,11.118,134418,46402,88016,7.759,22.476,78379,31527,46852,5.272,13.106,56039,9.37,26.211,2385,2431,21557
1994,33,25474,29982,453606,444596,3606,12.162,2940,9.916,72662,23853,48809,5.365,16.343,54750,19864,34886,4.468,12.315,17912,4.029,24.629,1990,2022,11114
1994,34,163394,190888,3100850,3095037,21781,11.483,19378,10.216,471421,165368,306053,5.343,15.232,459490,158427,301063,5.119,14.846,11931,0.385,29.692,13158,13432,78565
1994,35,29823,35608,481582,470914,4799,13.709,3594,10.267,89247,32008,57239,6.797,18.952,67875,24307,43568,5.162,14.413,21372,4.538,28.827,2518,2557,13946
1994,36,345395,404510,6569213,6555940,45762,11.34,43848,10.865,976433,353393,623040,5.39,14.894,950266,323352,626914,4.932,14.495,26167,0.399,28.989,31324,31860,179756
1994,37,127045,159885,2845591,2786365,18764,11.905,14227,9.026,443573,158486,285087,5.688,15.919,325246,109823,215423,3.941,11.673,118327,4.247,23.346,9765,10009,58720
1994,38,15140,17933,222624,219369,1702,9.576,1383,7.781,31957,10208,21749,4.653,14.568,25455,8130,17325,3.706,11.604,6502,2.964,23.207,987,1009,4815
1994,39,183294,234556,4336454,4276037,23667,10.176,19698,8.47,639381,218230,421151,5.104,14.953,518420,165768,352652,3.877,12.124,120961,2.829,24.248,13069,13473,77615
1994,40,59676,72397,1002866,989160,8713,12.173,7067,9.874,161676,58870,102806,5.952,16.345,134589,46317,88272,4.682,13.606,27087,2.738,27.213,5046,5128,26751
1994,41,67231,80107,1113638,1085677,10814,13.788,7460,9.512,196556,71697,124859,6.604,18.104,140324,47274,93050,4.354,12.925,56232,5.179,25.85,5198,5304,27921
1994,42,205856,256039,4535797,4529843,23736,9.29,22652,8.866,627434,216148,411286,4.772,13.851,614320,210820,403500,4.654,13.562,13114,0.29,27.123,15441,15821,107517
1994,44,21493,24192,370535,369375,2724,11.342,2374,9.885,57002,24255,32747,6.566,15.432,54357,20299,34058,5.495,14.716,2645,0.716,29.432,1668,1703,9675
1994,45,62347,77802,1351496,1331044,9370,12.182,7597,9.877,213998,82063,131935,6.165,16.077,173332,64226,109106,4.825,13.022,40666,3.055,26.045,5189,5310,34191
1994,46,17068,19837,258081,253541,2173,11.117,1591,8.14,38332,12955,25377,5.11,15.119,29451,9656,19795,3.808,11.616,8881,3.503,23.232,1135,1157,5844
1994,47,87700,110480,2020338,1988325,13002,11.917,10249,9.394,324451,124598,199853,6.266,16.318,260585,100708,159877,5.065,13.106,63866,3.212,26.212,7054,7208,46948
1994,48,301730,386463,6371718,6294388,50933,13.355,40770,10.69,1136964,429306,707658,6.82,18.063,981872,342156,639716,5.436,15.599,155092,2.464,31.198,27893,28729,187644
1994,49,31504,38070,698330,676699,5682,15.325,3696,9.968,130749,48144,82605,7.115,19.322,87476,33875,53601,5.006,12.927,43273,6.395,25.854,2634,2710,21230
1994,50,15812,17916,213662,211668,1846,10.38,1582,8.896,29922,9905,20017,4.68,14.136,25847,9020,16827,4.261,12.211,4075,1.925,24.422,1119,1137,4997
1994,51,112398,142934,2379345,2351572,16525,11.69,13383,9.467,371970,133246,238724,5.666,15.818,316632,106093,210539,4.512,13.465,55338,2.353,26.929,8792,9015,50328
1994,53,109175,130785,1880971,1861608,17527,13.605,13613,10.567,308523,112426,196097,6.039,16.573,270320,80413,189907,4.32,14.521,38203,2.052,29.042,9378,9576,46558
1994,54,29631,36108,508337,504320,3833,10.723,3109,8.697,73530,25783,47747,5.112,14.58,65765,20857,44908,4.136,13.04,7765,1.54,26.081,2164,2182,10480
1994,55,97375,118379,2103473,2078820,11746,10.014,9568,8.158,277826,91189,186637,4.387,13.365,228524,72774,155750,3.501,10.993,49302,2.372,21.986,6664,6841,38517
1994,56,12520,14574,150729,146888,1852,12.969,1265,8.858,27560,10988,16572,7.481,18.763,19850,5988,13862,4.077,13.514,7710,5.249,27.027,839,856,3570
1995,01,70187,87485,1519312,1484008,10648,12.345,8190,9.495,249733,86307,163426,5.816,16.828,178917,60529,118388,4.079,12.056,70816,4.772,24.113,5767,5906,35898
1995,02,12055,14409,176689,174767,1897,13.36,1477,10.402,30366,10311,20055,5.9,17.375,26500,7893,18607,4.516,15.163,3866,2.212,30.326,977,1005,4553
1995,04,72439,89346,1499527,1456032,13021,14.843,9777,11.145,294320,114281,180039,7.849,20.214,206544,81631,124913,5.606,14.185,87776,6.028,28.371,6657,6856,49279
1995,05,45400,54453,881792,859202,6749,12.566,5264,9.801,148047,50573,97474,5.886,17.231,102611,41517,61094,4.832,11.943,45436,5.288,23.885,3736,3787,22724
1995,06,531888,656332,10722042,10572597,82709,12.666,76053,11.647,1866479,662227,1204252,6.264,17.654,1569036,558096,1010940,5.279,14.841,297443,2.813,29.681,51386,53085,316449
1995,08,87313,103744,1554117,1506596,15036,14.829,10336,10.194,306872,120496,186376,7.998,20.369,211073,74658,136415,4.955,14.01,95799,6.359,28.02,7242,7349,44229
1995,09,69687,82303,1392252,1380865,8641,10.579,7400,9.059,200002,76498,123504,5.54,14.484,177141,56072,121069,4.061,12.828,22861,1.656,25.657,5041,5237,27779
1995,10,15463,18504,330895,322467,2391,13.129,1807,9.922,57799,19699,38100,6.109,17.924,40510,15556,24954,4.824,12.563,17289,5.361,25.125,1172,1196,6682
1995,11,14338,17359,390648,391156,1829,10.585,1668,9.654,52019,16201,35818,4.142,13.299,53727,15842,37885,4.05,13.735,-1708,-0.437,26.598,1050,1075,6927
1995,12,290704,355192,5203312,5105800,50427,14.352,42753,12.168,1021111,427762,593349,8.378,19.999,825392,317907,507485,6.226,16.166,195719,3.833,32.332,31251,32106,203552
1995,13,126405,159699,2896478,2812186,21796,13.895,16113,10.272,541554,210514,331040,7.486,19.257,372490,141613,230877,5.036,13.246,169064,6.012,26.491,11036,11311,71827
1995,15,21899,27614,421327,421419,2903,10.551,2705,9.831,55332,22398,32934,5.315,13.13,55914,16748,39166,3.974,13.268,-582,-0.138,26.26,1850,1894,8729
1995,16,24649,28861,375167,369046,3860,13.635,2759,9.746,64363,22084,42279,5.984,17.44,52159,20495,31664,5.554,14.133,12204,3.307,28.267,1913,1941,9112
1995,17,214642,262168,4906811,4829639,28920,11.147,23449,9.039,760450,270734,489716,5.606,15.745,605534,198308,407226,4.106,12.538,154916,3.208,25.076,15795,16186,102323
1995,18,102307,128871,2381846,2331748,14354,11.282,11061,8.694,367416,131081,236335,5.622,15.757,267526,89610,177916,3.843,11.473,99890,4.284,22.946,7740,7994,47475
1995,19,57727,71334,1116138,1095882,6931,9.793,5817,8.219,156197,48639,107558,4.438,14.253,116156,39900,76256,3.641,10.599,40041,3.654,21.199,4091,4202,23899
1995,20,52913,64423,973287,957709,6993,10.958,5782,9.06,141564,50902,90662,5.315,14.782,110234,36976,73258,3.861,11.51,31330,3.271,23.02,4084,4190,21997
1995,21,63149,78017,1343801,1314612,8759,11.358,6966,9.033,215650,75412,140238,5.736,16.404,156420,55316,101104,4.208,11.899,59230,4.506,23.797,4896,4999,29394
1995,22,70703,87822,1414074,1392745,9860,11.332,8231,9.46,243992,91776,152216,6.59,17.519,200850,74642,126208,5.359,14.421,43142,3.098,28.842,5681,5911,40599
1995,23,26738,31341,432174,425812,3665,11.826,2965,9.567,63141,20822,42319,4.89,14.828,49778,15361,34417,3.607,11.69,13363,3.138,23.38,2056,2100,10010
1995,24,89059,109566,1814881,1778458,13165,12.158,10593,9.783,302470,105274,197196,5.919,17.007,229151,83533,145618,4.697,12.885,73319,4.123,25.77,7167,7380,43879
1995,25,118410,143592,2706483,2668464,16094,11.337,12839,9.044,413782,139512,274270,5.228,15.506,336521,116781,219740,4.376,12.611,77261,2.895,25.222,8568,9017,63578
1995,26,163571,202481,3671136,3584277,22546,11.275,17503,8.753,596965,204815,392150,5.714,16.655,425173,143292,281881,3.998,11.862,171792,4.793,23.724,12096,12403,77591
1995,27,91308,111427,2046036,2004693,11949,10.848,9398,8.532,299865,104131,195734,5.194,14.958,216441,69059,147382,3.445,10.797,83424,4.161,21.593,6343,6536,39824
1995,28,42534,52120,858362,842613,6131,11.89,5020,9.735,142430,54319,88111,6.446,16.903,110838,38936,71902,4.621,13.154,31592,3.749,26.308,3593,3699,21742
1995,29,102763,125993,2140846,2105741,14819,11.879,12332,9.885,342327,113100,229227,5.371,16.257,272567,97501,175066,4.63,12.944,69760,3.313,25.888,8651,8880,51770
1995,30,21939,25442,260335,254506,3185,12.727,2353,9.402,42873,16485,26388,6.477,16.846,31245,11200,20045,4.401,12.277,11628,4.569,24.553,1665,1688,7523
1995,31,35390,42674,660647,645076,4147,9.791,3506,8.278,97975,34374,63601,5.329,15.188,66976,22272,44704,3.453,10.383,30999,4.805,20.765,2508,2561,12639
1995,32,28127,33302,662550,641274,5392,16.631,3629,11.194,123767,51171,72596,7.98,19.3,81582,26666,54916,4.158,12.722,42185,6.578,25.444,2597,2653,19389
1995,33,26322,30979,472883,462261,3805,12.485,2798,9.181,74393,27477,46916,5.944,16.093,53234,18869,34365,4.082,11.516,21159,4.577,23.032,1946,2038,11812
1995,34,167744,195750,3194624,3144406,23496,12.155,18606,9.625,517518,189023,328495,6.011,16.458,414619,147462,267157,4.69,13.186,102899,3.272,26.372,12948,13213,78229
1995,35,30623,36586,502318,491061,4781,13.247,3793,10.509,89151,33403,55748,6.802,18.155,66130,25317,40813,5.156,13.467,23021,4.688,26.934,2670,2726,15252
1995,36,350085,410001,6631990,6595502,47331,11.623,41732,10.248,981819,348278,633541,5.281,14.886,905732,297356,608376,4.508,13.733,76087,1.154,27.465,29949,30537,168302
1995,37,131510,165413,2967656,2904366,19651,12.084,14067,8.65,456403,155007,301396,5.337,15.714,327779,110551,217228,3.806,11.286,128624,4.429,22.571,9718,9988,57264
1995,38,15391,18208,232051,226803,1675,9.27,1398,7.737,35866,12068,23798,5.321,15.814,25420,9438,15982,4.161,11.208,10446,4.606,22.416,973,985,5151
1995,39,187043,239445,4506526,4418155,24823,10.475,19896,8.396,678800,229618,449182,5.197,15.364,503030,162469,340561,3.677,11.386,175770,3.978,22.771,13275,13736,84753
1995,40,60673,73623,1034078,1018411,8491,11.631,7257,9.94,166944,61566,105378,6.045,16.393,135196,50048,85148,4.914,13.275,31748,3.117,26.55,5240,5368,28695
1995,41,69339,82706,1170811,1141547,10865,13.348,8252,10.138,204624,72500,132124,6.351,17.925,146631,51963,94668,4.552,12.845,57993,5.08,25.69,5798,5974,32864
1995,42,208959,260211,4665580,4600559,25708,9.96,21507,8.332,661877,232705,429172,5.058,14.387,531254,189562,341692,4.12,11.548,130623,2.839,23.095,14565,15086,104389
1995,44,21710,24486,372413,368076,2612,10.735,2304,9.469,53467,17490,35977,4.752,14.526,44785,14504,30281,3.94,12.167,8682,2.359,24.335,1618,1639,7656
1995,45,64129,80017,1397883,1374654,9951,12.613,7711,9.774,217218,80100,137118,5.827,15.802,169434,62263,107171,4.529,12.326,47784,3.476,24.651,5382,5559,35382
1995,46,17422,20275,270026,264031,2071,10.326,1632,8.137,38561,11645,26916,4.41,14.605,26585,9983,16602,3.781,10.069,11976,4.536,20.138,1169,1192,5623
1995,47,90115,113607,2128681,2072184,13616,12.153,10475,9.35,358863,130246,228617,6.285,17.318,244816,84125,160691,4.06,11.814,114047,5.504,23.629,7165,7370,45552
1995,48,308878,396094,6679979,6523097,51802,13.241,42079,10.755,1251519,473002,778517,7.251,19.186,939498,341113,598385,5.229,14.403,312021,4.783,28.805,28744,29736,188913
1995,49,33113,40013,742893,720198,5913,15.147,3960,10.144,141014,54806,86208,7.61,19.58,95413,34039,61374,4.726,13.248,45601,6.332,26.496,2797,2875,19422
1995,50,16100,18252,219459,218141,1898,10.493,1570,8.68,32729,11808,20921,5.413,15.004,29850,10871,18979,4.983,13.684,2879,1.32,27.368,1124,1134,6436
1995,51,115826,146949,2473437,2428016,17518,12.086,13508,9.319,402903,146821,256082,6.047,16.594,311114,113405,197709,4.671,12.814,91789,3.78,25.627,9045,9317,53216
1995,53,111433,133599,1931783,1905839,17595,13.311,14767,11.171,313416,112605,200811,5.908,16.445,261577,92345,169232,4.845,13.725,51839,2.72,27.45,10149,10388,55320
1995,54,30326,36961,529501,519674,4040,11.06,3177,8.697,83375,29350,54025,5.648,16.044,63265,21953,41312,4.224,12.174,20110,3.87,24.348,2177,2202,11224
1995,55,99149,120652,2184431,2142457,11971,10.017,9683,8.102,300839,98455,202384,4.595,14.042,217483,67376,150107,3.145,10.151,83356,3.891,20.302,6832,7053,39145
1995,56,12898,14961,153869,157822,1781,12.061,1392,9.427,25316,8837,16479,5.599,16.041,32439,7235,25204,4.584,20.554,-7123,-4.513,32.082,948,960,4314
1996,01,71126,89080,1523444,1516502,10648,12.083,8729,9.906,231302,82790,148512,5.459,15.252,216931,75241,141690,4.961,14.305,14371,0.948,28.609,6282,6400,40155
1996,02,12234,14612,177524,176614,1835,12.685,1543,10.666,29578,8721,20857,4.938,16.747,28037,10164,17873,5.755,15.875,1541,0.873,31.75,1009,1029,5395
1996,04,74317,92066,1562675,1524940,13202,14.588,10067,11.124,291343,107276,184067,7.035,19.105,215152,80341,134811,5.268,14.109,76191,4.996,28.218,6979,7165,49232
1996,05,45781,55081,889927,883210,6446,11.793,5605,10.254,130691,45538,85153,5.156,14.797,117013,37145,79868,4.206,13.249,13678,1.549,26.497,4068,4181,23059
1996,06,537192,662724,10846916,10749637,83839,12.742,74315,11.295,1895748,667840,1227908,6.213,17.635,1700374,611131,1089243,5.685,15.818,195374,1.817,31.636,50487,52071,334016
1996,08,89512,106383,1571898,1557425,14739,14.057,11669,11.129,295976,119192,176784,7.653,19.004,267877,112078,155799,7.196,17.2,28099,1.804,34.4,7995,8139,55665
1996,09,69463,82314,1393557,1389554,8066,9.821,7695,9.369,198806,76497,122309,5.505,14.307,191562,64488,127074,4.641,13.786,7244,0.521,27.572,5183,5363,32162
1996,10,15634,18671,331360,330094,2188,11.812,1893,10.219,48652,18615,30037,5.639,14.739,46147,15329,30818,4.644,13.98,2505,0.759,27.96,1209,1245,7060
1996,11,14330,17390,362581,372754,1843,10.634,1726,9.959,47452,17215,30237,4.618,12.73,66736,16437,50299,4.41,17.904,-19284,-5.173,25.46,1080,1111,7264
1996,12,294581,360465,5291616,5233223,50254,14.069,43709,12.237,1009031,407063,601968,7.778,19.281,894529,348107,546422,6.652,17.093,114502,2.188,34.187,31623,32337,203300
1996,13,129675,163975,2952316,2917185,22434,13.889,17526,10.851,520267,202077,318190,6.927,17.835,451397,172550,278847,5.915,15.474,68870,2.361,30.947,11924,12186,80083
1996,15,21719,27338,415323,417818,2803,10.225,2952,10.769,60665,27633,33032,6.614,14.519,65414,21733,43681,5.202,15.656,-4749,-1.137,29.039,1901,2007,10527
1996,16,25326,29643,384873,378345,3995,13.684,3097,10.608,71085,25611,45474,6.769,18.788,58370,21315,37055,5.634,15.428,12715,3.361,30.855,2133,2158,11760
1996,17,216003,264620,4887129,4873034,28498,10.843,24920,9.481,705782,246230,459552,5.053,14.483,679283,209906,469377,4.308,13.94,26499,0.544,27.879,17034,17479,102850
1996,18,103043,130254,2375621,2369959,13692,10.585,11885,9.188,342365,129719,212646,5.473,14.446,330570,108614,221956,4.583,13.948,11795,0.498,27.897,8208,8449,54466
1996,19,57925,71818,1137982,1123600,6712,9.396,5942,8.318,154005,53369,100636,4.75,13.706,124932,36655,88277,3.262,11.119,29073,2.587,22.238,4194,4277,22299
1996,20,53247,65001,989812,976534,6924,10.726,6030,9.341,150206,54179,96027,5.548,15.382,123872,44666,79206,4.574,12.685,26334,2.697,25.37,4269,4377,25618
1996,21,63525,78975,1347153,1341549,8667,11.062,7409,9.457,197276,75410,121866,5.621,14.705,185934,60525,125409,4.512,13.86,11342,0.845,27.719,5238,5359,33342
1996,22,71747,89300,1441510,1422576,9809,11.095,8033,9.086,236504,80815,155689,5.681,16.625,198330,63999,134331,4.499,13.942,38174,2.683,27.883,5677,5802,36385
1996,23,27143,31815,434032,431704,3707,11.762,3113,9.877,59978,22812,37166,5.284,13.893,55327,18834,36493,4.363,12.816,4651,1.077,25.632,2162,2184,10910
1996,24,89458,110220,1802879,1800526,12299,11.217,11143,10.163,276159,103317,172842,5.738,15.338,273406,92401,181005,5.132,15.185,2753,0.153,30.37,7469,7645,48620
1996,25,119207,144739,2701901,2688391,15201,10.57,13357,9.287,389028,130042,258986,4.837,14.471,363127,141923,221204,5.279,13.507,25901,0.963,27.014,8760,9072,67097
1996,26,165434,205485,3658972,3645129,22006,10.813,18049,8.869,520115,180590,339525,4.954,14.269,494856,147696,347160,4.052,13.576,25259,0.693,27.152,12731,13080,84530
1996,27,92853,113274,2075495,2052609,11992,10.699,9623,8.585,291449,99206,192243,4.833,14.199,245257,78903,166354,3.844,11.949,46192,2.25,23.897,6607,6786,47025
1996,28,42936,52844,853499,851671,6126,11.691,5235,9.991,128717,52624,76093,6.179,15.113,124477,43071,81406,5.057,14.616,4240,0.498,29.231,3800,3865,25066
1996,29,103459,127393,2141899,2127312,14304,11.316,12330,9.754,321784,114301,207483,5.373,15.126,292888,97194,195694,4.569,13.768,28896,1.358,27.536,8889,9047,50293
1996,30,22436,25874,263335,260920,3127,12.211,2597,10.141,41280,15716,25564,6.023,15.821,36352,13471,22881,5.163,13.932,4928,1.889,27.864,1728,1754,8440
1996,31,35515,42903,673850,665495,4168,9.761,3765,8.817,93979,31830,62149,4.783,14.122,77155,27434,49721,4.122,11.594,16824,2.528,23.187,2650,2710,13887
1996,32,29056,34622,697298,676653,5544,16.361,4072,12.017,143140,63013,80127,9.312,21.154,102219,38910,63309,5.75,15.107,40921,6.048,30.213,2838,2890,22917
1996,33,26902,31663,478343,471535,3767,12.05,2964,9.481,71304,23838,47466,5.055,15.122,57668,19327,38341,4.099,12.23,13636,2.892,24.46,2011,2085,11497
1996,34,169090,197323,3164099,3162111,22630,11.536,20308,10.353,498888,180491,318397,5.708,15.777,497221,178807,318414,5.655,15.724,1667,0.053,31.449,14111,14375,81284
1996,35,31023,37227,504941,499196,4707,12.781,3909,10.614,89404,33180,56224,6.647,17.91,77710,28427,49283,5.695,15.567,11694,2.343,31.134,2694,2737,15624
1996,36,351233,411547,6596739,6589149,46723,11.394,43755,10.67,956927,350735,606192,5.323,14.523,941710,324136,617574,4.919,14.292,15217,0.231,28.584,31588,32300,189879
1996,37,134495,169373,3013513,2981287,20065,12.009,15473,9.261,453803,173833,279970,5.831,15.222,389236,131198,258038,4.401,13.056,64567,2.166,26.112,10379,10636,61086
1996,38,15449,18276,231993,231027,1622,8.907,1489,8.177,32312,10179,22133,4.406,13.986,30213,9856,20357,4.266,13.078,2099,0.909,26.155,1020,1042,5088
1996,39,187643,241076,4533434,4503454,23735,9.901,21029,8.772,647599,224167,423432,4.978,14.38,586425,186798,399627,4.148,13.022,61174,1.358,26.043,14081,14495,93587
1996,40,61120,74446,1053781,1040649,8619,11.666,7491,10.139,169613,67100,102513,6.448,16.299,143825,53346,90479,5.126,13.821,25788,2.478,27.641,5444,5554,30547
1996,41,70699,84542,1210610,1185998,10730,12.857,8554,10.25,207098,71582,135516,6.036,17.462,158304,54280,104024,4.577,13.348,48794,4.114,26.696,6065,6196,34371
1996,42,208584,260954,4641531,4628372,24755,9.52,22930,8.818,626224,226053,400171,4.884,13.53,601916,206365,395551,4.459,13.005,24308,0.525,26.01,15611,16057,104198
1996,44,21776,24592,369036,369569,2597,10.602,2403,9.81,48590,16094,32496,4.355,13.148,49846,16804,33042,4.547,13.488,-1256,-0.34,26.296,1689,1699,8879
1996,45,65268,81721,1415849,1403565,10166,12.593,8173,10.125,216814,82446,134368,5.874,15.447,191646,61547,130099,4.385,13.654,25168,1.793,27.308,5650,5808,34482
1996,46,17584,20525,273534,270781,2167,10.649,1817,8.929,38597,16617,21980,6.137,14.254,32896,10782,22114,3.982,12.149,5701,2.105,24.297,1309,1343,6594
1996,47,91298,115872,2149909,2135112,13838,12.082,11168,9.751,331242,129992,201250,6.088,15.514,301668,106220,195448,4.975,14.129,29574,1.385,28.258,7898,8050,55794
1996,48,313697,402555,6804088,6716445,51744,12.985,43619,10.946,1226085,477295,748790,7.106,18.255,1050564,371522,679042,5.532,15.642,175521,2.613,31.283,29896,30910,203791
1996,49,34613,41780,773103,755743,6212,15.217,4297,10.526,138331,57107,81224,7.556,18.304,103364,35219,68145,4.66,13.677,34967,4.627,27.354,3039,3116,22371
1996,50,16147,18352,220851,219446,1889,10.339,1728,9.457,31580,11958,19622,5.449,14.391,28722,11918,16804,5.431,13.088,2858,1.302,26.177,1244,1265,6551
1996,51,116816,148714,2498158,2479616,16988,11.514,14655,9.932,390862,142800,248062,5.759,15.763,355115,117933,237182,4.756,14.321,35747,1.442,28.643,9870,10172,56082
1996,53,112906,135839,1950337,1932233,18244,13.571,15435,11.481,313244,118475,194769,6.132,16.212,276574,92156,184418,4.769,14.314,36670,1.898,28.627,10545,10786,58339
1996,54,30328,37150,522447,524995,3850,10.407,3541,9.571,74410,28462,45948,5.421,14.173,79514,25805,53709,4.915,15.146,-5104,-0.972,28.347,2427,2461,14442
1996,55,99799,121826,2196318,2180472,11708,9.678,10002,8.268,275298,91007,184291,4.174,12.626,243092,73133,169959,3.354,11.149,32206,1.477,22.297,7059,7207,38174
1996,56,13130,15220,152809,152708,1840,12.221,1513,10.049,22944,8422,14522,5.515,15.025,22903,6511,16392,4.264,14.998,41,0.027,29.996,1060,1091,4544
1997,01,71725,90134,1553745,1540729,10825,12.079,9790,10.924,268404,101674,166730,6.599,17.421,242843,88993,153850,5.776,15.762,25561,1.659,31.523,6671,6810,47023
1997,02,12433,14844,183967,180768,1909,12.978,1641,11.156,36405,10317,26088,5.707,20.139,30184,9560,20624,5.289,16.698,6221,3.441,33.395,1044,1056,4793
1997,04,76503,95101,1659269,1617575,14503,15.495,11495,12.281,358648,141051,217597,8.72,22.172,276807,114632,162175,7.087,17.112,81841,5.059,34.225,7461,7633,51921
1997,05,46044,55603,900173,896184,6741,12.181,6218,11.236,141306,53229,88077,5.94,15.768,133225,50902,82323,5.68,14.866,8081,0.902,29.732,4327,4439,26445
1997,06,542945,667642,11259838,11072231,87181,13.104,82468,12.396,2239485,807509,1431976,7.293,20.226,1859923,735419,1124504,6.642,16.798,379562,3.428,33.596,51687,53590,365443
1997,08,91851,109444,1648754,1615715,15796,14.635,12780,11.84,336101,135764,200337,8.403,20.802,269720,107807,161913,6.672,16.694,66381,4.108,33.387,8423,8580,52799
1997,09,69512,82466,1461550,1434954,8524,10.345,8382,10.173,256230,91031,165199,6.344,17.856,202107,76797,125310,5.352,14.085,54123,3.772,28.169,5361,5524,35767
1997,10,15983,19111,346501,340697,2451,12.97,2023,10.705,59956,21538,38418,6.322,17.598,48750,17549,31201,5.151,14.309,11206,3.289,28.618,1278,1294,8440
1997,11,14243,17210,368064,365015,1893,10.942,2073,11.983,57429,20473,36956,5.609,15.733,50916,18560,32356,5.085,13.949,6513,1.784,27.898,1171,1228,7599
1997,12,297188,365475,5437926,5378084,52589,14.488,47622,13.119,1102776,439740,663036,8.177,20.505,980488,419407,561081,7.798,18.231,122288,2.274,36.462,33284,34203,230760
1997,13,131967,167367,3032320,2992628,22654,13.672,19301,11.649,574894,214938,359956,7.182,19.21,496124,188037,308087,6.283,16.578,78770,2.632,33.156,12792,13102,93774
1997,15,21653,27207,418159,417968,2835,10.393,2976,10.91,60952,21174,39778,5.066,14.583,60337,20704,39633,4.953,14.436,615,0.147,28.872,1908,1965,10970
1997,16,26070,30531,395518,390448,4359,14.486,3479,11.562,73838,27736,46102,7.104,18.911,64276,24970,39306,6.395,16.462,9562,2.449,32.924,2300,2346,13692
1997,17,217242,266190,4994075,4954543,29116,10.97,27578,10.39,800962,276189,524773,5.574,16.166,722895,253660,469235,5.12,14.591,78067,1.576,29.181,17796,18325,122797
1997,18,103512,131344,2436208,2408423,14241,10.889,13131,10.04,384765,126005,258760,5.232,15.976,329211,117296,211915,4.87,13.669,55554,2.307,27.338,8711,8999,60474
1997,19,57998,72058,1155958,1148689,6937,9.645,6668,9.271,174757,64089,110668,5.579,15.214,160215,58804,101411,5.119,13.948,14542,1.266,27.895,4382,4495,27907
1997,20,53728,65819,1026848,1009883,7432,11.361,6628,10.132,172908,64827,108081,6.419,17.122,138952,49670,89282,4.918,13.759,33956,3.362,27.518,4345,4438,25510
1997,21,64138,79981,1398256,1373817,9072,11.414,8073,10.157,239694,83551,156143,6.082,17.447,190361,68960,121401,5.02,13.856,49333,3.591,27.713,5348,5502,35639
1997,22,72563,90395,1478100,1461000,10359,11.528,9291,10.339,267501,92422,175079,6.326,18.309,233218,84950,148268,5.815,15.963,34283,2.347,31.926,6165,6338,41958
1997,23,27579,32422,444227,438676,3808,11.855,3207,9.984,68034,24177,43857,5.511,15.509,57255,22376,34879,5.101,13.052,10779,2.457,26.104,2156,2202,12322
1997,24,90208,111265,1882497,1848096,13533,12.217,12543,11.323,355925,134312,221613,7.268,19.259,287280,110256,177024,5.966,15.545,68645,3.714,31.089,8040,8286,50924
1997,25,121403,147366,2786377,2746473,16300,11.158,13740,9.405,462167,171699,290468,6.252,16.828,383588,134093,249495,4.882,13.967,78579,2.861,27.933,8829,9056,67560
1997,26,166977,206855,3768978,3721258,22395,10.861,21062,10.215,637987,210154,427833,5.647,17.144,538361,190030,348331,5.107,14.467,99626,2.677,28.934,13704,14217,92584
1997,27,94614,115528,2146824,2114456,12945,11.314,10711,9.362,339764,113138,226626,5.351,16.069,275363,96560,178803,4.567,13.023,64401,3.046,26.046,6875,7107,47738
1997,28,43284,53546,886022,872738,6287,11.819,5587,10.503,150012,51909,98103,5.948,17.189,123304,39221,84083,4.494,14.128,26708,3.06,28.257,3875,3929,21614
1997,29,103409,127627,2211936,2180045,14266,11.187,14051,11.019,365525,118695,246830,5.445,16.767,301377,104614,196763,4.799,13.824,64148,2.943,27.649,9584,9878,55676
1997,30,22948,26386,269343,266419,3208,12.275,2705,10.35,47523,16988,30535,6.376,17.838,41700,15148,26552,5.686,15.652,5823,2.186,31.304,1819,1844,8405
1997,31,35820,43242,682373,677994,4407,10.236,4033,9.367,105750,40455,65295,5.967,15.597,97150,31242,65908,4.608,14.329,8600,1.268,28.658,2671,2751,16886
1997,32,30475,36507,749335,727404,6437,18.095,4571,12.849,156980,62774,94206,8.63,21.581,113482,40882,72600,5.62,15.601,43498,5.98,31.202,2990,3053,20378
1997,33,27372,32216,495456,488297,3734,11.69,3187,9.977,78328,25734,52594,5.27,16.041,63972,23388,40584,4.79,13.101,14356,2.94,26.202,2081,2126,11764
1997,34,171616,200069,3267888,3222887,24830,12.496,22097,11.121,609529,221024,388505,6.858,18.913,515179,205324,309855,6.371,15.985,94350,2.927,31.97,14568,14954,99922
1997,35,31121,37630,515883,511266,4888,13.062,4471,11.948,96708,39053,57655,7.638,18.915,87812,30113,57699,5.89,17.175,8896,1.74,34.351,2952,2996,17156
1997,36,354633,415138,6746877,6690817,49442,11.959,46037,11.135,1108483,379620,728863,5.674,16.567,994373,381351,613022,5.7,14.862,114110,1.705,29.724,32360,33014,195385
1997,37,138427,175458,3111654,3064500,23013,13.348,16912,9.809,520081,193560,326521,6.316,16.971,425392,152451,272941,4.975,13.881,94689,3.09,27.763,10980,11269,72354
1997,38,15309,18135,240821,236641,1648,9.054,1783,9.795,39096,12509,26587,5.286,16.521,30515,11779,18736,4.978,12.895,8581,3.626,25.79,1204,1234,7625
1997,39,188528,242378,4618171,4583175,25081,10.375,23832,9.858,726478,264682,461796,5.775,15.851,654801,225152,429649,4.913,14.287,71677,1.564,28.574,14919,15424,101329
1997,40,61671,75419,1098088,1077456,9235,12.323,8281,11.05,202700,75351,127349,6.993,18.813,161023,56176,104847,5.214,14.945,41677,3.868,29.889,5691,5823,33694
1997,41,71864,86024,1270717,1246532,11080,12.989,9643,11.304,236726,79864,156862,6.407,18.991,187284,68817,118467,5.521,15.024,49442,3.966,30.049,6461,6565,35284
1997,42,209973,263375,4754270,4703245,26916,10.266,24548,9.363,749673,265079,484594,5.636,15.939,647768,237615,410153,5.052,13.773,101905,2.167,27.546,15740,16329,120757
1997,44,22010,24821,384939,380587,2644,10.698,2430,9.832,59560,20102,39458,5.282,15.65,51018,17124,33894,4.499,13.405,8542,2.244,26.81,1726,1746,9838
1997,45,66645,83681,1453081,1435029,10756,13.006,8791,10.63,245189,94237,150952,6.567,17.086,208675,77808,130867,5.422,14.542,36514,2.544,29.083,5870,6010,42452
1997,46,17646,20651,279689,276762,2200,10.688,2067,10.042,42203,15368,26835,5.553,15.249,36533,12502,24031,4.517,13.2,5670,2.049,26.4,1355,1400,7246
1997,47,91967,117452,2207372,2182992,14195,12.167,12631,10.826,376557,135875,240682,6.224,17.25,327333,114623,212710,5.251,14.995,49224,2.255,29.989,8414,8682,59554
1997,48,316890,408126,7090092,6961700,53302,13.148,47837,11.8,1430103,547886,882217,7.87,20.542,1171902,442549,729353,6.357,16.834,258201,3.709,33.667,31674,32741,236779
1997,49,35991,43422,820683,798175,6561,15.397,4942,11.598,172151,66932,105219,8.386,21.568,125506,51474,74032,6.449,15.724,46645,5.844,31.448,3297,3389,24170
1997,50,16341,18577,227549,224025,2026,10.973,1800,9.749,34706,15193,19513,6.782,15.492,28031,10435,17596,4.658,12.512,6675,2.98,25.025,1264,1277,6116
1997,51,118994,151707,2615453,2556193,18690,12.441,15724,10.467,478727,171062,307665,6.692,18.728,360624,132518,228106,5.184,14.108,118103,4.62,28.216,9852,10256,62145
1997,53,114715,138127,2001276,1966056,18952,13.834,16696,12.187,385065,136392,248673,6.937,19.586,313347,119922,193425,6.1,15.938,71718,3.648,31.876,10755,10989,62100
1997,54,30487,37522,535970,530051,4104,10.99,3748,10.036,86214,31598,54616,5.961,16.265,74196,24890,49306,4.696,13.998,12018,2.267,27.996,2487,2553,12946
1997,55,100756,123195,2254985,2230691,12320,10.055,10988,8.968,326515,109309,217206,4.9,14.637,277765,95209,182556,4.268,12.452,48750,2.185,24.904,7232,7472,47296
1997,56,13253,15199,156028,154299,1799,11.83,1816,11.941,29625,10355,19270,6.711,19.2,26124,10801,15323,7.0,16.931,3501,2.269,33.862,1061,1072,4636
1998,01,72282,91187,1601010,1592379,10210,11.242,9481,10.439,248817,87572,161245,5.499,15.625,230370,84162,146208,5.285,14.467,18447,1.158,28.934,6467,6639,40200
1998,02,12724,15182,196287,191975,1903,12.641,1648,10.947,36786,12740,24046,6.636,19.162,28295,9074,19221,4.727,14.739,8491,4.423,29.478,1021,1057,4664
1998,04,77967,97288,1759384,1713727,13109,13.603,11263,11.688,350670,138820,211850,8.1,20.462,259716,94565,165151,5.518,15.155,90954,5.307,30.31,7416,7602,51446
1998,05,46037,55977,938379,923565,6381,11.419,6189,11.075,152712,60354,92358,6.535,16.535,122877,45130,77747,4.887,13.305,29835,3.23,26.609,4249,4349,25082
1998,06,554088,681270,11887951,11648540,84499,12.503,73607,10.891,2215321,733896,1481425,6.3,19.018,1734547,641571,1092976,5.508,14.891,480774,4.127,29.781,46889,48106,316901
1998,08,94590,113250,1760742,1713944,15711,14.085,12305,11.031,345729,127701,218028,7.451,20.172,251762,89119,162643,5.2,14.689,93967,5.483,29.378,8233,8338,45775
1998,09,69806,82954,1484757,1478182,8039,9.702,7845,9.468,226884,79303,147581,5.365,15.349,214827,72614,142213,4.912,14.533,12057,0.816,29.066,4970,5081,28245
1998,10,16476,19716,354575,351717,2449,12.562,2009,10.305,61245,22389,38856,6.366,17.413,54312,19149,35163,5.444,15.442,6933,1.971,30.884,1222,1237,7533
1998,11,14355,17402,384141,381378,1796,10.351,1693,9.758,57368,19714,37654,5.169,15.042,51616,16864,34752,4.422,13.534,5752,1.508,27.068,935,963,7181
1998,12,301355,370619,5730368,5611861,50235,13.629,46174,12.527,1168912,460763,708149,8.211,20.829,929776,389746,540030,6.945,16.568,239136,4.261,33.136,30616,31605,200155
1998,13,135241,172017,3205670,3146048,23141,13.613,19092,11.231,606389,237329,369060,7.544,19.275,484757,185577,299180,5.899,15.408,121632,3.866,30.817,12137,12520,84020
1998,15,21679,27129,410968,414021,2645,9.716,2834,10.41,57350,22394,34956,5.409,13.852,63214,22657,40557,5.472,15.268,-5864,-1.416,27.704,1749,1787,9839
1998,16,26661,31321,422735,413240,4069,13.132,3397,10.963,79840,31801,48039,7.696,19.32,60568,19898,40670,4.815,14.657,19272,4.664,29.314,2301,2321,11319
1998,17,220297,270679,5185991,5122724,27972,10.401,24482,9.103,797359,259241,538118,5.061,15.565,668797,217741,451056,4.25,13.055,128562,2.51,26.111,15946,16332,99778
1998,18,104559,133013,2534183,2504499,13441,10.153,12188,9.206,381476,134414,247062,5.367,15.232,321141,108038,213103,4.314,12.823,60335,2.409,25.645,7959,8163,50648
1998,19,58661,73075,1218944,1195866,6755,9.289,6044,8.311,174644,55067,119577,4.605,14.604,128662,41169,87493,3.443,10.759,45982,3.845,21.518,3991,4085,21238
1998,20,54422,66891,1075857,1060000,7078,10.64,6343,9.535,174484,62230,112254,5.871,16.461,142202,54322,87880,5.125,13.415,32282,3.045,26.831,4197,4326,24974
1998,21,64966,81394,1447168,1429080,8829,10.927,7637,9.452,235392,92195,143197,6.451,16.472,198037,64854,133183,4.538,13.858,37355,2.614,27.715,5024,5125,29816
1998,22,73462,91577,1564048,1539942,9812,10.765,8955,9.825,272441,92973,179468,6.037,17.692,222707,77513,145194,5.034,14.462,49734,3.23,28.924,5847,6035,42117
1998,23,28260,33222,461386,455339,3786,11.517,3090,9.4,67370,22860,44510,5.02,14.796,54671,19356,35315,4.251,12.007,12699,2.789,24.013,2065,2096,10177
1998,24,91176,112385,1946482,1922550,12544,11.198,11814,10.546,327937,120957,206980,6.291,17.057,279448,104143,175305,5.417,14.535,48489,2.522,29.071,7296,7568,48494
1998,25,123371,149680,2878033,2846606,15006,10.084,13271,8.918,454440,147654,306786,5.187,15.964,388914,131718,257196,4.627,13.662,65526,2.302,27.325,8276,8463,53928
1998,26,168546,209281,3891948,3850869,21251,10.194,19633,9.418,595599,200925,394674,5.218,15.467,512448,169164,343284,4.393,13.307,83151,2.159,26.615,12858,13398,83138
1998,27,97103,118288,2248146,2210584,12227,10.437,9941,8.486,348692,110630,238062,5.005,15.774,273966,85799,188167,3.881,12.393,74726,3.38,24.787,6452,6602,42441
1998,28,43734,54275,939711,926291,5996,11.103,5453,10.097,142924,49057,93867,5.296,15.43,116287,42390,73897,4.576,12.554,26637,2.876,25.108,3738,3824,22416
1998,29,104536,129363,2284258,2267694,13944,10.829,12740,9.894,333777,119007,214770,5.248,14.719,300901,95330,205571,4.204,13.269,32876,1.45,26.538,8462,8664,47777
1998,30,23495,27039,278263,275977,3327,12.433,2770,10.351,46010,17763,28247,6.436,16.672,41443,16372,25071,5.932,15.017,4567,1.655,30.034,1910,1950,8374
1998,31,36144,43763,712777,701945,4187,9.601,3884,8.906,104924,32577,72347,4.641,14.948,82928,29761,53167,4.24,11.814,21996,3.134,23.628,2624,2699,15210
1998,32,31978,38539,811282,786550,6248,16.621,4354,11.582,164135,72195,91940,9.179,20.868,114060,37690,76370,4.792,14.501,50075,6.366,29.003,2866,2897,18613
1998,33,28015,32821,520469,510161,3505,10.763,2991,9.185,83357,25328,58029,4.965,16.339,62659,21776,40883,4.268,12.282,20698,4.057,24.564,1923,1959,11675
1998,34,174742,203848,3390540,3350746,23404,11.571,20242,10.008,584920,196448,388472,5.863,17.456,505233,182089,323144,5.434,15.078,79687,2.378,30.156,13074,13279,78309
1998,35,31497,38160,538364,534052,4531,11.932,4155,10.942,91406,34666,56740,6.491,17.116,82885,31842,51043,5.962,15.52,8521,1.596,31.04,2687,2768,14978
1998,36,360722,422523,6925329,6861398,46647,11.122,40429,9.639,1135756,358681,777075,5.228,16.553,1005829,337088,668741,4.913,14.659,129927,1.894,29.318,27144,27580,149342
1998,37,141584,178996,3224568,3185122,21205,11.946,18214,10.261,512620,189700,322920,5.956,16.094,433365,165818,267547,5.206,13.606,79255,2.488,27.212,11173,11443,68575
1998,38,15436,18268,250927,247125,1649,9.046,1573,8.629,37561,12316,25245,4.984,15.199,30194,11412,18782,4.618,12.218,7367,2.981,24.436,1034,1066,5480
1998,39,190383,244972,4786387,4729773,23086,9.455,21453,8.787,722891,230456,492435,4.872,15.284,610216,219011,391205,4.63,12.902,112675,2.382,25.803,13514,13987,88504
1998,40,62416,76387,1155734,1134066,8559,11.252,7921,10.413,200913,68540,132373,6.044,17.716,157520,63529,93991,5.602,13.89,43393,3.826,27.78,5260,5433,33285
1998,41,73089,87455,1303533,1292159,10548,12.141,9396,10.815,216465,79262,137203,6.134,16.752,192221,69987,122234,5.416,14.876,24244,1.876,29.752,6098,6207,33799
1998,42,212311,266411,4882996,4839979,24796,9.344,22685,8.549,707753,227979,479774,4.71,14.623,620542,210628,409914,4.352,12.821,87211,1.802,25.642,14229,14689,90711
1998,44,22361,25161,402725,395629,2488,9.939,2232,8.916,60245,20268,39977,5.123,15.228,45625,12890,32735,3.258,11.532,14620,3.695,23.065,1508,1521,6355
1998,45,68202,85710,1530938,1501176,10296,12.137,8538,10.065,259443,87115,172328,5.803,17.283,200345,71203,129142,4.743,13.346,59098,3.937,26.692,5523,5632,32762
1998,46,17901,20936,292159,287236,2133,10.237,1935,9.286,41991,12394,29597,4.315,14.619,32235,11583,20652,4.033,11.222,9756,3.397,22.445,1330,1367,6382
1998,47,92706,119131,2302969,2266431,13610,11.489,12272,10.359,381803,146968,234835,6.485,16.846,307411,107528,199883,4.744,13.564,74392,3.282,27.127,8038,8248,49569
1998,48,322626,416366,7533047,7363957,51841,12.552,45139,10.929,1454474,527718,926756,7.166,19.751,1115209,389017,726192,5.283,15.144,339265,4.607,30.288,28774,30018,186171
1998,49,37098,44818,843635,835607,6317,14.297,5048,11.425,157318,58800,98518,7.037,18.827,140934,44181,96753,5.287,16.866,16384,1.961,33.732,3321,3371,22317
1998,50,16501,18686,237683,233341,1866,10.001,1811,9.706,35550,11508,24042,4.932,15.235,26832,9735,17097,4.172,11.499,8718,3.736,22.998,1224,1254,5725
1998,51,121294,155043,2696393,2666088,18156,11.819,15300,9.96,443106,165743,277363,6.217,16.62,380968,143633,237335,5.387,14.289,62138,2.331,28.579,9374,9747,64333
1998,53,117384,141434,2090143,2058897,18064,12.899,15270,10.904,356522,119024,237498,5.781,17.316,293954,101251,192703,4.918,14.277,62568,3.039,28.555,10079,10248,53918
1998,54,30616,37892,549678,544713,3716,9.841,3449,9.134,85718,32936,52782,6.046,15.736,76155,23522,52633,4.318,13.981,9563,1.756,27.962,2286,2314,11260
1998,55,102137,124910,2317765,2293840,11670,9.391,10381,8.354,315052,95597,219455,4.168,13.735,266456,90247,176209,3.934,11.616,48596,2.119,23.232,6780,6967,41894
1998,56,13599,15621,163744,162160,1843,11.93,1497,9.691,28759,10556,18203,6.51,17.735,25655,9552,16103,5.89,15.821,3104,1.914,31.642,1023,1039,4643
1999,01,72286,91668,1620816,1611206,9796,10.715,9315,10.188,254373,96016,158357,5.959,15.788,235112,85477,149635,5.305,14.592,19261,1.195,29.185,6281,6454,40771
1999,02,12782,15309,195871,195543,1731,11.356,1598,10.484,28729,8339,20390,4.265,14.692,28041,7905,20136,4.043,14.34,688,0.352,28.68,1049,1069,4447
1999,04,79469,99703,1816831,1785639,13859,14.07,11450,11.625,354358,136679,217679,7.654,19.845,291599,118644,172955,6.644,16.33,62759,3.515,32.66,7317,7586,56648
1999,05,46072,56318,949769,944147,6357,11.318,6054,10.779,142667,50161,92506,5.313,15.111,131898,49246,82652,5.216,13.97,10769,1.141,27.94,4150,4277,25363
1999,06,561848,691273,12153478,12034974,84487,12.31,74606,10.87,2160410,763151,1397259,6.341,17.951,1927581,716622,1210959,5.954,16.016,232829,1.935,32.033,46993,48576,350257
1999,08,96546,116153,1824028,1794670,15611,13.61,12715,11.085,351896,136321,215575,7.596,19.608,292799,115495,177304,6.435,16.315,59097,3.293,32.63,8391,8645,53459
1999,09,69658,83178,1518078,1502234,7726,9.298,7548,9.084,227397,74451,152946,4.956,15.137,194598,71468,123130,4.757,12.954,32799,2.183,25.908,4897,5036,29929
1999,10,16858,20126,363896,359447,2454,12.315,2056,10.318,63650,29360,34290,8.168,17.708,54413,19686,34727,5.477,15.138,9237,2.57,30.276,1222,1251,8176
1999,11,14332,17452,390652,387516,1806,10.364,1754,10.065,56581,20679,35902,5.336,14.601,49844,18738,31106,4.835,12.862,6737,1.739,25.725,970,995,7515
1999,12,303194,374671,5933375,5842126,50622,13.585,46519,12.484,1185178,412682,772496,7.064,20.287,1000921,411473,589448,7.043,17.133,184257,3.154,34.266,31281,32317,211759
1999,13,137504,175177,3330437,3268625,22492,12.957,19305,11.121,608006,225013,382993,6.884,18.601,481636,182410,299226,5.581,14.735,126370,3.866,29.47,12330,12788,88616
1999,15,21572,26976,415841,414030,2566,9.486,2716,10.04,59112,24172,34940,5.838,14.277,55651,20491,35160,4.949,13.441,3461,0.836,26.883,1693,1764,10784
1999,16,27238,32267,436578,430019,4180,13.143,3253,10.228,72077,28970,43107,6.737,16.761,58749,23603,35146,5.489,13.662,13328,3.099,27.324,2215,2249,12974
1999,17,220878,272348,5302039,5254013,26969,9.932,25354,9.337,779298,254105,525193,4.836,14.832,681437,234900,446537,4.471,12.97,97861,1.863,25.94,16248,16729,106839
1999,18,104356,133485,2584947,2562162,12661,9.5,12233,9.179,372649,124805,247844,4.871,14.544,326776,109594,217182,4.277,12.754,45873,1.79,25.508,8231,8477,57022
1999,19,58509,73369,1243999,1232127,6438,8.789,6195,8.458,176142,58441,117701,4.743,14.296,152100,53124,98976,4.312,12.345,24042,1.951,24.689,4239,4355,24616
1999,20,54448,67230,1097024,1086022,6758,10.078,6418,9.571,172974,62559,110415,5.76,15.927,150109,60688,89421,5.588,13.822,22865,2.105,27.644,4235,4356,25410
1999,21,65169,82103,1471678,1458723,8505,10.406,7756,9.49,228094,81936,146158,5.617,15.637,202379,66190,136189,4.538,13.874,25715,1.763,27.747,5213,5374,33542
1999,22,73293,91886,1574517,1571540,9382,10.227,9087,9.905,245625,83067,162558,5.286,15.63,239424,86815,152609,5.524,15.235,6201,0.395,30.47,6056,6277,49347
1999,23,28835,33889,473182,467461,3680,10.963,3038,9.05,70256,23664,46592,5.062,15.029,58828,19501,39327,4.172,12.585,11428,2.445,25.169,2045,2096,12105
1999,24,91760,113220,1979341,1962441,12221,10.835,11365,10.076,330020,117207,212813,5.973,16.817,294769,109345,185424,5.572,15.021,35251,1.796,30.041,7147,7294,52397
1999,25,125651,152286,2935627,2909331,16079,10.648,13510,8.947,448955,145610,303345,5.005,15.432,396562,132574,263988,4.557,13.631,52393,1.801,27.261,8563,8833,61834
1999,26,168533,210336,3962887,3930087,20493,9.767,19451,9.271,603568,214836,388732,5.466,15.358,536228,175123,361105,4.456,13.644,67340,1.713,27.288,12892,13245,85702
1999,27,98336,120290,2300910,2274603,12396,10.39,10430,8.742,336747,116922,219825,5.14,14.805,283622,101418,182204,4.459,12.469,53125,2.336,24.938,6722,6945,45126
1999,28,43795,54649,945925,941513,6008,11.029,5660,10.39,141009,49105,91904,5.216,14.977,132798,49754,83044,5.284,14.105,8211,0.872,28.209,3936,4014,24471
1999,29,104728,130238,2335384,2311555,13661,10.523,12824,9.878,351113,118867,232246,5.142,15.189,303114,107030,196084,4.63,13.113,47999,2.076,26.226,8634,8833,49038
1999,30,23690,27329,287538,282311,3016,11.092,2738,10.07,47728,16402,31326,5.81,16.906,37404,14075,23329,4.986,13.249,10324,3.657,26.498,1865,1908,8554
1999,31,36285,44020,728484,721322,4022,9.159,3804,8.663,106673,32766,73907,4.542,14.789,91937,35670,56267,4.945,12.746,14736,2.043,25.491,2578,2670,21010
1999,32,33292,40590,852408,832710,6722,16.987,4687,11.844,173984,72446,101538,8.7,20.894,134460,52510,81950,6.306,16.147,39524,4.746,32.295,3087,3188,22534
1999,33,28313,33442,531742,525877,3472,10.477,2866,8.648,74399,25299,49100,4.811,14.148,62502,19678,42824,3.742,11.885,11897,2.262,23.771,1946,1996,10851
1999,34,175509,205222,3445525,3420099,22219,10.863,20844,10.191,550794,193195,357599,5.649,16.105,498581,171749,326832,5.022,14.578,52213,1.527,29.156,13659,13973,89916
1999,35,31356,38372,539408,540104,4421,11.551,4227,11.044,86473,32762,53711,6.066,16.01,87574,29432,58142,5.449,16.214,-1101,-0.204,32.021,2783,2844,16350
1999,36,362618,426568,7039982,6986199,45312,10.672,41313,9.731,1056616,350364,706252,5.015,15.124,948374,325660,622714,4.661,13.575,108242,1.549,27.15,28036,28544,165902
1999,37,143869,182389,3323875,3277175,21069,11.661,17654,9.771,555425,197966,357459,6.041,16.948,461156,165844,295312,5.061,14.072,94269,2.877,28.144,11418,11842,73834
1999,38,15379,18314,251415,251717,1490,8.144,1453,7.942,32176,12033,20143,4.78,12.783,32354,9921,22433,3.941,12.853,-178,-0.071,25.565,1005,1024,5541
1999,39,190093,245692,4828065,4814135,21974,8.957,21272,8.67,684711,225390,459321,4.682,14.223,658636,224389,434247,4.661,13.681,26075,0.542,27.363,13610,14173,94494
1999,40,62312,76666,1155040,1156288,8494,11.098,8237,10.762,187361,69982,117379,6.052,16.204,190655,69853,120802,6.041,16.489,-3294,-0.285,32.407,5490,5655,35149
1999,41,73543,88456,1319251,1310923,10429,11.856,9438,10.73,212565,74301,138264,5.668,16.215,195659,78441,117218,5.984,14.925,16906,1.29,29.851,6342,6526,39123
1999,42,212411,267234,4938748,4913544,23974,8.984,23206,8.696,695718,241092,454626,4.907,14.159,646127,219013,427114,4.457,13.15,49591,1.009,26.3,14907,15363,96958
1999,44,22260,25204,409654,408200,2386,9.473,2353,9.342,55481,16613,38868,4.07,13.592,52745,16058,36687,3.934,12.921,2736,0.67,25.843,1650,1664,7856
1999,45,69438,87398,1565010,1546919,10315,11.918,8617,9.956,249446,90149,159297,5.828,16.125,214923,73826,141097,4.772,13.894,34523,2.232,27.787,5588,5859,35660
1999,46,17964,21115,297777,294933,2096,9.967,1926,9.158,39915,14681,25234,4.978,13.534,34267,11414,22853,3.87,11.619,5648,1.915,23.237,1345,1383,6341
1999,47,92360,119728,2340880,2326960,13224,11.074,12603,10.554,370520,139801,230719,6.008,15.923,345277,125875,219402,5.409,14.838,25243,1.085,29.676,8202,8515,56252
1999,48,323323,420826,7690130,7620218,51032,12.19,46635,11.14,1418894,502508,916386,6.594,18.62,1279056,490449,788607,6.436,16.785,139838,1.835,33.57,30389,31486,233404
1999,49,38104,46492,881087,870313,6798,14.889,5132,11.24,154075,60132,93943,6.909,17.703,131990,50520,81470,5.805,15.166,22085,2.538,30.332,3471,3572,29134
1999,50,16744,19082,244352,241199,1960,10.377,1573,8.328,33942,11625,22317,4.82,14.072,27417,9208,18209,3.818,11.367,6525,2.705,22.734,1149,1168,5969
1999,51,122061,156398,2776721,2737758,17101,10.982,15734,10.104,448737,156082,292655,5.701,16.391,370505,128343,242162,4.688,13.533,78232,2.858,27.066,9597,9938,60247
1999,53,118168,142870,2152784,2122555,17388,12.231,15983,11.242,367066,135972,231094,6.406,17.294,306734,110208,196526,5.192,14.451,60332,2.842,28.902,10614,11024,60520
1999,54,30533,37832,545780,545901,3598,9.509,3611,9.543,76251,29445,46806,5.394,13.968,76608,26924,49684,4.932,14.033,-357,-0.065,27.936,2377,2440,12723
1999,55,102491,125954,2360403,2338989,11327,9.028,10337,8.239,316303,97735,218568,4.179,13.523,273553,86750,186803,3.709,11.695,42750,1.828,23.391,6958,7163,43974
1999,56,13568,15692,169409,166653,1767,11.285,1699,10.851,30088,10704,19384,6.423,18.054,24586,9086,15500,5.452,14.753,5502,3.301,29.506,1145,1154,4715
2000,01,71700,91211,1657799,1641042,9304,10.173,9804,10.719,260686,81178,179508,4.947,15.885,228117,87142,140975,5.31,13.901,32569,1.985,27.801,6455,6677,43554
2000,02,12790,15246,203513,200215,1776,11.618,1857,12.148,38727,13690,25037,6.838,19.343,32247,14607,17640,7.296,16.106,6480,3.237,32.212,1113,1148,6102
2000,04,80333,101496,1901434,1863430,13661,13.576,11917,11.843,380269,140439,239830,7.537,20.407,303935,117627,186308,6.312,16.311,76334,4.096,32.621,7650,7903,51547
2000,05,46189,56649,988105,969557,6338,11.218,6041,10.692,154533,50288,104245,5.187,15.939,116876,43618,73258,4.499,12.055,37657,3.884,24.109,3999,4086,22276
2000,06,569887,701615,12673401,12429864,84143,12.08,74027,10.628,2367110,791954,1575156,6.371,19.044,1877060,719253,1157807,5.786,15.101,490050,3.943,30.202,46566,48352,322520
2000,08,98413,118519,1903547,1866734,15644,13.33,13320,11.35,365059,131958,233101,7.069,19.556,289657,117871,171786,6.314,15.517,75402,4.039,31.034,8352,8658,52499
2000,09,69798,83329,1540467,1532235,7559,9.076,7466,8.965,217134,72652,144482,4.742,14.171,200099,71983,128116,4.698,13.059,17035,1.112,26.119,4658,4832,29518
2000,10,17288,20738,377912,370962,2705,13.226,2133,10.429,70760,31267,39493,8.429,19.075,57333,24479,32854,6.599,15.455,13427,3.62,30.91,1280,1305,6965
2000,11,14400,17621,404251,397310,1770,10.086,1625,9.26,57885,18579,39306,4.676,14.569,44433,12517,31916,3.15,11.183,13452,3.386,22.367,902,910,5821
2000,12,303875,376143,6156719,6040900,48848,13.011,47453,12.639,1196635,415160,781475,6.872,19.809,962871,423059,539812,7.003,15.939,233764,3.87,31.878,30831,31727,192347
2000,13,138604,177301,3430680,3383762,22381,12.697,20329,11.533,614990,221939,393051,6.559,18.175,520951,200712,320239,5.932,15.396,94039,2.779,30.791,12709,13032,88032
2000,15,21768,27139,430787,423608,2616,9.668,2456,9.076,63172,22093,41079,5.215,14.913,48733,20417,28316,4.82,11.504,14439,3.409,23.009,1498,1548,8561
2000,16,27542,32662,452670,447567,3974,12.24,3586,11.045,82581,34202,48379,7.642,18.451,71869,24522,47347,5.479,16.058,10712,2.393,32.115,2313,2388,13395
2000,17,221228,273707,5419386,5365921,27288,9.993,26033,9.533,852488,265989,586499,4.957,15.887,743806,286677,457129,5.343,13.862,108682,2.025,27.723,16331,16809,114743
2000,18,103915,133343,2683367,2635480,12675,9.498,12875,9.648,411849,135089,276760,5.126,15.627,317753,115214,202539,4.372,12.057,94096,3.57,24.113,8150,8425,49821
2000,19,58380,73338,1276166,1262822,6202,8.452,6290,8.572,169942,58418,111524,4.626,13.457,142949,51067,91882,4.044,11.32,26993,2.138,22.64,4097,4230,23198
2000,20,54511,67551,1116009,1106446,6810,10.103,6515,9.666,170743,64838,105905,5.86,15.432,152698,55732,96966,5.037,13.801,18045,1.631,27.602,4200,4298,23761
2000,21,64890,82135,1523336,1499795,8099,9.86,8106,9.869,237882,80208,157674,5.348,15.861,190191,71054,119137,4.738,12.681,47691,3.18,25.362,5168,5305,33691
2000,22,72836,91809,1590402,1583303,9436,10.271,9557,10.403,263139,102904,160235,6.499,16.62,248431,93895,154536,5.93,15.691,14708,0.929,31.381,6013,6231,50525
2000,23,29203,34443,491587,483004,3609,10.556,3100,9.067,72629,23568,49061,4.879,15.037,55489,21479,34010,4.447,11.488,17140,3.549,22.977,2100,2147,11006
2000,24,92059,113962,2065751,2030674,12064,10.616,11410,10.041,351219,113701,237518,5.599,17.296,282006,106378,175628,5.239,13.887,69213,3.408,27.775,7107,7279,42927
2000,25,127080,154368,3044389,2994256,15777,10.288,13748,8.965,497192,154633,342559,5.164,16.605,397642,151231,246411,5.051,13.28,99550,3.325,26.56,8574,8956,63638
2000,26,168615,210688,4036685,4009402,20469,9.722,20193,9.591,619760,205643,414117,5.129,15.458,567636,216257,351379,5.394,14.158,52124,1.3,28.315,12614,12989,89246
2000,27,99360,121736,2370751,2339497,12013,9.922,10679,8.821,350285,111322,238963,4.758,14.973,287197,90998,196199,3.89,12.276,63088,2.697,24.552,6889,7099,44715
2000,28,43276,54484,958978,952464,5593,10.249,5769,10.571,138143,51857,86286,5.445,14.504,124716,44825,79891,4.706,13.094,13427,1.41,26.188,3853,3950,22609
2000,29,104759,130736,2375237,2356976,13519,10.358,13075,10.018,357444,118116,239328,5.011,15.165,321370,112019,209351,4.753,13.635,36074,1.531,27.27,8657,8874,50083
2000,30,23935,27719,298329,293168,3120,11.33,2758,10.015,48588,15768,32820,5.378,16.573,38257,13901,24356,4.742,13.05,10331,3.524,26.099,1858,1895,8501
2000,31,36505,44509,751033,740024,4256,9.613,3785,8.549,111866,38907,72959,5.258,15.117,90096,29229,60867,3.95,12.175,21770,2.942,24.349,2414,2493,12365
2000,32,34286,41926,912911,884269,6533,15.83,5221,12.651,182382,67387,114995,7.621,20.625,124589,45189,79400,5.11,14.089,57793,6.536,28.179,3323,3388,22285
2000,33,28479,33677,558059,545587,3376,10.057,3157,9.405,92621,29603,63018,5.426,16.976,68295,25121,43174,4.604,12.518,24326,4.459,25.035,1970,2033,12217
2000,34,175915,206728,3550869,3501347,22300,10.825,20850,10.121,599693,193762,405931,5.534,17.127,501795,187694,314101,5.361,14.331,97898,2.796,28.663,13401,13699,81372
2000,35,31202,38382,553491,547717,4317,11.245,4331,11.282,92835,32986,59849,6.022,16.949,81433,29998,51435,5.477,14.868,11402,2.082,29.735,2826,2897,15784
2000,36,365100,430864,7271778,7169525,45720,10.662,41613,9.704,1142931,374632,768299,5.225,15.942,935978,351463,584515,4.902,13.055,206953,2.887,26.11,27319,27952,162985
2000,37,144552,183963,3409789,3371582,19775,10.791,18344,10.011,529992,180557,349435,5.355,15.719,455384,167592,287792,4.971,13.507,74608,2.213,27.013,11826,12360,75756
2000,38,15248,18193,254816,253036,1411,7.726,1551,8.493,32809,9162,23647,3.621,12.966,29108,9698,19410,3.833,11.504,3701,1.463,23.007,1103,1134,6075
2000,39,189663,246187,4968553,4913398,22125,8.994,21767,8.848,766021,250589,515432,5.1,15.59,658228,230669,427559,4.695,13.397,107793,2.194,26.793,13397,13930,90814
2000,40,62034,76659,1199850,1178858,8157,10.639,8183,10.673,208729,75471,133258,6.402,17.706,167117,64383,102734,5.461,14.176,41612,3.53,28.352,5301,5467,31458
2000,41,73730,88766,1342814,1333494,9940,11.215,9673,10.914,221247,82933,138314,6.219,16.592,202272,71249,131023,5.343,15.169,18975,1.423,30.337,6277,6482,34549
2000,42,212919,268605,5056277,5000017,24058,8.975,22962,8.566,750100,259200,490900,5.184,15.002,638567,225381,413186,4.508,12.771,111533,2.231,25.543,14311,14871,89963
2000,44,22347,25392,417402,414275,2446,9.665,2278,9.001,62391,20598,41793,4.972,15.06,56175,22251,33924,5.371,13.56,6216,1.5,27.12,1507,1546,8174
2000,45,69745,88036,1611754,1595738,9693,11.048,9097,10.368,256562,86444,170118,5.417,16.078,225809,79442,146367,4.978,14.151,30753,1.927,28.302,5795,5993,38229
2000,46,18060,21247,307667,303472,1999,9.433,1889,8.914,47024,14826,32198,4.885,15.495,38428,13037,25391,4.296,12.663,8596,2.833,25.326,1269,1314,6025
2000,47,91695,119599,2379649,2354495,12544,10.48,12732,10.637,386969,126975,259994,5.393,16.435,337748,131530,206218,5.586,14.345,49221,2.091,28.69,7991,8248,48688
2000,48,324200,423628,7984715,7849201,50015,11.842,47496,11.245,1494917,534235,960682,6.806,19.045,1225695,486504,739191,6.198,15.616,269222,3.43,31.231,29615,30959,208587
2000,49,38847,47739,908668,894999,6570,13.942,5337,11.326,159069,59680,99389,6.668,17.773,131935,48106,83829,5.375,14.741,27134,3.032,29.483,3546,3627,25331
2000,50,16794,19201,253781,249074,1819,9.498,1718,8.971,38164,12764,25400,5.125,15.322,28736,9758,18978,3.918,11.537,9428,3.785,23.074,1204,1214,5219
2000,51,123033,158151,2894360,2840915,17243,10.96,15604,9.918,493861,169257,324604,5.958,17.384,387526,147852,239674,5.204,13.641,106335,3.743,27.282,9495,9813,57287
2000,53,118803,143851,2224544,2196925,17111,11.933,16203,11.299,385808,128548,257260,5.851,17.561,328334,113257,215077,5.155,14.945,57474,2.616,29.89,10493,10859,57343
2000,54,30308,37767,563467,556685,3536,9.351,3629,9.597,81757,30190,51567,5.423,14.686,68592,23923,44669,4.297,12.322,13165,2.365,24.643,2287,2370,12324
2000,55,102678,126898,2416490,2389211,11566,9.146,10688,8.452,334513,111772,222741,4.678,14.001,279592,97992,181600,4.101,11.702,54921,2.299,23.405,6981,7180,42198
2000,56,13717,15869,174698,171951,1683,10.662,1516,9.604,29561,9282,20279,5.398,17.192,24061,8506,15555,4.947,13.993,5500,3.199,27.986,974,998,4404
2001,01,70683,90775,1609148,1632079,9530,10.474,9946,10.932,234069,95854,138215,5.873,14.342,278872,100478,178394,6.156,17.087,-44803,-2.745,28.684,6419,6743,51769
2001,02,12738,15333,210583,206657,1821,11.928,1687,11.051,36718,11989,24729,5.801,17.768,28829,10118,18711,4.896,13.95,7889,3.817,27.9,1021,1050,5212
2001,04,81538,103257,1940556,1923563,14049,13.721,12320,12.032,356753,137192,219561,7.132,18.546,323077,128512,194565,6.681,16.796,33676,1.751,33.592,7424,7661,52815
2001,05,45611,56484,982092,984597,6196,10.954,6360,11.244,142625,56560,86065,5.744,14.486,147258,52476,94782,5.33,14.956,-4633,-0.471,28.971,4311,4443,28484
2001,06,575519,711094,12940292,12803096,86581,12.254,77442,10.961,2270498,779541,1490957,6.089,17.734,1998098,722159,1275939,5.641,15.606,272400,2.128,31.213,49292,50961,360759
2001,08,100202,121381,1978862,1943183,16541,13.79,13683,11.407,387969,146069,241900,7.517,19.966,317848,119127,198721,6.131,16.357,70121,3.609,32.714,8851,9063,55978
2001,09,69250,83277,1544302,1542884,7740,9.295,7729,9.282,217975,79615,138360,5.16,14.128,214523,76141,138382,4.935,13.904,3452,0.224,27.808,4732,4887,28296
2001,10,17639,21265,385353,381716,2635,12.546,2110,10.046,65043,25477,39566,6.674,17.04,57385,18759,38626,4.914,15.033,7658,2.006,30.067,1284,1322,8225
2001,11,14321,17646,411890,409013,1849,10.534,1662,9.469,62725,22374,40351,5.47,15.336,56476,21499,34977,5.256,13.808,6249,1.528,27.616,919,943,7096
2001,12,307750,381979,6350420,6252738,52251,13.782,46558,12.28,1292295,478928,813367,7.659,20.668,1105745,458067,647678,7.326,17.684,186550,2.983,35.368,29564,30483,190524
2001,13,139911,179760,3433609,3434699,22953,12.856,20512,11.489,566512,220905,345607,6.432,16.494,569518,212243,357275,6.179,16.581,-3006,-0.088,32.988,12538,13174,94483
2001,15,22067,27531,438526,434838,2794,10.217,2423,8.861,61007,23119,37888,5.317,14.03,53948,20190,33758,4.643,12.406,7059,1.623,24.813,1440,1491,8330
2001,16,27818,33002,462663,457892,4233,12.884,3938,11.986,81057,30855,50202,6.738,17.702,72258,26968,45290,5.89,15.781,8799,1.922,31.561,2334,2407,14391
2001,17,220374,273556,5361593,5393156,26676,9.75,26777,9.787,755289,269460,485829,4.996,14.005,820382,271124,549258,5.027,15.212,-65093,-1.207,28.009,16729,17394,116375
2001,18,103148,132824,2589269,2623965,12721,9.562,13158,9.89,339681,120744,218937,4.602,12.945,408966,142826,266140,5.443,15.586,-69285,-2.64,25.891,7987,8292,62132
2001,19,57600,72834,1244800,1255541,6044,8.266,6606,9.035,144463,48768,95695,3.884,11.506,166765,50220,116545,4.0,13.282,-22302,-1.776,23.012,4267,4409,24884
2001,20,54159,67439,1109332,1115801,6702,9.927,6843,10.136,147098,54286,92812,4.865,13.183,160296,53155,107141,4.764,14.366,-13198,-1.183,26.366,4365,4473,25426
2001,21,64710,82055,1509116,1516669,8027,9.778,8097,9.864,206538,70269,136269,4.633,13.618,221859,73418,148441,4.841,14.628,-15321,-1.01,27.236,5057,5247,33688
2001,22,72646,91741,1587178,1588766,9365,10.205,9426,10.271,239121,82337,156784,5.182,15.051,243026,81057,161969,5.102,15.297,-3905,-0.246,30.101,5721,5924,42560
2001,23,29305,34742,495684,493560,3621,10.473,3289,9.512,69788,27450,42338,5.562,14.14,65968,23640,42328,4.79,13.366,3820,0.774,26.732,2224,2256,11463
2001,24,92783,115003,2078007,2073045,12734,11.125,11646,10.175,326154,121576,204578,5.865,15.733,316279,111733,204546,5.39,15.257,9875,0.476,30.513,6923,7310,51008
2001,25,127300,155158,3085366,3062714,15419,9.967,14489,9.366,484553,157795,326758,5.152,15.821,438001,156784,281217,5.119,14.301,46552,1.52,28.602,9091,9334,71979
2001,26,167483,210409,3965173,4004478,20746,9.856,20912,9.935,571641,198998,372643,4.969,14.275,648846,210601,438245,5.259,16.203,-77205,-1.928,28.55,12948,13394,91947
2001,27,99983,123635,2374234,2370884,13029,10.622,11069,9.024,334317,126439,207878,5.333,14.101,328528,109321,219207,4.611,13.857,5789,0.244,27.714,6999,7203,48690
2001,28,42680,54043,921757,941470,5608,10.336,6036,11.125,124601,48567,76034,5.159,13.235,164334,62369,101965,6.625,17.455,-39733,-4.22,26.469,3844,4010,31870
2001,29,103550,130230,2371580,2373254,12781,9.797,13228,10.14,335438,119285,216153,5.026,14.134,337756,118406,219350,4.989,14.232,-2318,-0.098,28.268,8689,8906,55057
2001,30,24196,28130,304995,301727,3128,11.2,2724,9.754,48674,17958,30716,5.952,16.132,41995,13792,28203,4.571,13.918,6679,2.214,27.836,1772,1801,9137
2001,31,36562,44799,741451,746027,4270,9.556,4036,9.033,100124,40020,60104,5.364,13.421,110003,37021,72982,4.962,14.745,-9879,-1.324,26.842,2513,2599,15895
2001,32,34970,42919,931908,922031,6590,15.529,5626,13.257,164432,64817,99615,7.03,17.834,146110,51537,94573,5.59,15.847,18322,1.987,31.693,3652,3746,28114
2001,33,28555,33809,557720,555889,3371,9.991,3233,9.582,77594,27964,49630,5.031,13.959,73554,27817,45737,5.004,13.232,4040,0.727,26.464,2073,2148,11579
2001,34,176796,208487,3610707,3579661,22684,10.925,20960,10.095,595783,202665,393118,5.662,16.644,531431,178278,353153,4.98,14.846,64352,1.798,29.692,13505,13796,82338
2001,35,31171,38458,557745,555349,4454,11.599,4335,11.29,94485,34390,60095,6.193,17.014,89676,32337,57339,5.823,16.148,4809,0.866,32.295,2584,2650,14675
2001,36,367335,433612,7260333,7255364,46193,10.692,43019,9.958,1037034,362119,674915,4.991,14.293,1028310,367273,661037,5.062,14.173,8724,0.12,28.346,27542,28123,173130
2001,37,145496,185528,3443221,3428927,20866,11.297,19225,10.408,555284,196345,358939,5.726,16.194,522782,185196,337586,5.401,15.246,32502,0.948,30.492,11881,12401,77722
2001,38,15179,18214,256521,255641,1525,8.371,1534,8.42,32694,12584,20110,4.923,12.789,31045,9391,21654,3.674,12.144,1649,0.645,24.288,1025,1042,6258
2001,39,188025,245473,4884860,4927084,21893,8.91,22371,9.105,649919,237033,412886,4.811,13.191,735683,221826,513857,4.502,14.931,-85764,-1.741,26.381,13605,14268,98343
2001,40,61829,76798,1209079,1205439,8203,10.69,8077,10.526,190526,70550,119976,5.853,15.806,183369,68253,115116,5.662,15.212,7157,0.594,30.424,5171,5301,31289
2001,41,73904,89544,1358252,1353448,10569,11.858,9740,10.928,218225,83614,134611,6.178,16.124,208639,65296,143343,4.824,15.415,9586,0.708,30.831,6296,6485,33394
2001,42,212480,269458,5063832,5059149,24943,9.274,23925,8.896,708214,261512,446702,5.169,13.999,696235,242640,453595,4.796,13.762,11979,0.237,27.524,14554,15253,107854
2001,44,22323,25429,413560,414989,2402,9.458,2336,9.198,52381,17361,35020,4.183,12.622,54578,15247,39331,3.674,13.152,-2197,-0.529,25.245,1521,1561,8377
2001,45,69563,88261,1598156,1605520,9792,11.11,9549,10.834,240692,89113,151579,5.55,14.992,254340,88929,165411,5.539,15.842,-13648,-0.85,29.983,6040,6299,43638
2001,46,18069,21353,313322,310626,2042,9.579,1969,9.237,45308,21175,24133,6.817,14.586,40678,13438,27240,4.326,13.095,4630,1.491,26.191,1280,1303,6577
2001,47,90638,119028,2351887,2365395,12511,10.489,12999,10.899,351857,126318,225539,5.34,14.875,378111,133459,244652,5.642,15.985,-26254,-1.11,29.75,7964,8322,67479
2001,48,325995,428254,8118288,8056839,51863,12.175,47338,11.112,1466306,567703,898603,7.046,18.2,1344106,529741,814365,6.575,16.683,122200,1.517,33.366,29154,30323,229223
2001,49,39825,48728,910595,910757,7044,14.595,6111,12.662,161596,62143,99453,6.823,17.743,164117,64768,99349,7.111,18.02,-2521,-0.277,35.486,3628,3724,29440
2001,50,16681,19145,254004,252206,1673,8.74,1667,8.709,32478,10325,22153,4.094,12.878,28975,10262,18713,4.069,11.489,3503,1.389,22.977,1156,1170,5973
2001,51,124013,159627,2932874,2918053,17486,11.008,15929,10.028,476442,180165,296277,6.174,16.327,446472,143394,303078,4.914,15.3,29970,1.027,30.601,9373,9771,61747
2001,53,119092,144930,2250725,2237692,17379,12.036,16301,11.289,363696,131197,232499,5.863,16.253,338499,112152,226347,5.012,15.127,25197,1.126,30.254,10331,10606,59538
2001,54,29680,37135,556725,559112,3250,8.684,3833,10.241,74868,24492,50376,4.381,13.391,79761,27563,52198,4.93,14.266,-4893,-0.875,26.781,2414,2469,11517
2001,55,102382,127066,2386640,2400598,11268,8.875,11069,8.718,284921,91776,193145,3.823,11.869,313418,99343,214075,4.138,13.056,-28497,-1.187,23.738,7057,7393,46704
2001,56,13859,16038,178490,176301,1810,11.341,1653,10.357,29227,10350,18877,5.871,16.578,24877,8269,16608,4.69,14.111,4350,2.467,28.221,1036,1053,4864
2002,01,70710,91361,1577671,1595089,10199,11.185,9841,10.793,256184,98816,157368,6.195,16.061,291443,95784,195659,6.005,18.271,-35259,-2.21,32.122,6153,6322,50306
2002,02,12843,15617,212881,212187,2128,13.747,1853,11.971,39584,15329,24255,7.224,18.655,38217,12594,25623,5.935,18.011,1367,0.644,36.022,1057,1070,6920
2002,04,82114,105004,1930259,1938419,14774,14.18,13147,12.618,385465,157670,227795,8.134,19.886,402128,138970,263158,7.169,20.745,-16663,-0.86,39.771,7997,8263,63712
2002,05,46002,57389,969271,978455,6869,12.048,6121,10.736,150397,53403,96994,5.458,15.371,169539,58855,110684,6.015,17.327,-19142,-1.956,30.742,3967,4059,36055
2002,06,578681,720950,12624100,12831137,94955,13.247,86627,12.085,2287803,923585,1364218,7.198,17.83,2704957,915572,1789385,7.136,21.081,-417154,-3.251,35.66,54234,55902,478357
2002,08,100766,122637,1912218,1951508,16607,13.591,15716,12.862,339274,136463,202811,6.993,17.385,418791,139463,279328,7.146,21.46,-79517,-4.075,34.77,9540,9782,65649
2002,09,68695,83164,1537019,1545691,8295,9.955,8623,10.348,235549,89671,145878,5.801,15.239,253403,84451,168952,5.464,16.394,-17854,-1.155,30.478,5169,5249,35971
2002,10,17537,21581,383666,385663,2692,12.544,2451,11.421,65439,30983,34456,8.034,16.968,68825,23119,45706,5.995,17.846,-3386,-0.878,33.936,1451,1502,9346
2002,11,14635,18077,413792,413942,2209,12.291,2000,11.128,68214,25847,42367,6.244,16.479,68213,24060,44153,5.812,16.479,1,0.0,32.958,1036,1056,11955
2002,12,312949,390003,6284308,6344881,56502,14.627,49045,12.697,1212676,494979,717697,7.801,19.113,1335282,496107,839175,7.819,21.045,-122606,-1.932,38.225,31125,31918,238453
2002,13,141423,182099,3364754,3417003,24241,13.386,22227,12.274,565164,236154,329010,6.911,16.54,671186,241948,429238,7.081,19.643,-106022,-3.103,33.08,13136,13512,117592
2002,15,22231,27841,439610,441606,3071,11.075,2848,10.271,66836,27973,38863,6.334,15.135,70628,23577,47051,5.339,15.993,-3792,-0.859,30.27,1677,1717,12329
2002,16,28116,33572,452160,457911,4443,13.333,3946,11.841,81947,34295,47652,7.489,17.896,92816,30522,62294,6.665,20.269,-10869,-2.374,35.792,2338,2388,18559
2002,17,218829,273439,5167738,5279377,29600,10.809,30423,11.109,784125,312186,471939,5.913,14.853,1010433,342271,668162,6.483,19.139,-226308,-4.287,29.705,17867,18513,170037
2002,18,103324,133826,2530186,2569844,14332,10.733,13740,10.29,377833,154582,223251,6.015,14.703,455792,139285,316507,5.42,17.736,-77959,-3.034,29.405,8093,8438,66514
2002,19,57325,72810,1227866,1243700,6809,9.336,7047,9.663,160640,62644,97996,5.037,12.916,192097,60224,131873,4.842,15.446,-31457,-2.529,25.833,4112,4254,31546
2002,20,54013,67721,1098656,1107037,7378,10.902,7289,10.77,173142,73255,99887,6.617,15.64,190491,62029,128462,5.603,17.207,-17349,-1.567,31.28,4424,4560,32109
2002,21,64518,82696,1459742,1476270,8817,10.691,8360,10.137,216852,81990,134862,5.554,14.689,249570,74552,175018,5.05,16.905,-32718,-2.216,29.378,5187,5312,35967
2002,22,73098,92774,1573383,1584595,10162,11.002,9337,10.109,258860,103314,155546,6.52,16.336,282603,95160,187443,6.005,17.834,-23743,-1.498,32.672,5754,5974,48779
2002,23,29181,34954,487594,494433,3871,11.088,3787,10.847,70027,28774,41253,5.82,14.163,83599,27403,56196,5.542,16.908,-13572,-2.745,28.326,2352,2387,15133
2002,24,93750,116923,2060281,2076616,14091,12.136,12470,10.74,334518,135742,198776,6.537,16.109,367592,128038,239554,6.166,17.701,-33074,-1.593,32.218,7240,7468,63865
2002,25,126582,155742,2982097,3040467,16608,10.669,16465,10.577,455274,174307,280967,5.733,14.974,573417,190169,383248,6.255,18.86,-118143,-3.886,29.948,10188,10412,89891
2002,26,165784,209689,3862564,3920641,22797,10.84,24046,11.433,628139,266600,361539,6.8,16.021,745778,252055,493723,6.429,19.022,-117639,-3.001,32.043,14349,14732,115419
2002,27,99855,124349,2347427,2370453,13878,11.179,13465,10.846,357106,132585,224521,5.593,15.065,402316,130205,272111,5.493,16.972,-45210,-1.907,30.13,7900,8127,61753
2002,28,42920,54576,912774,919147,6209,11.419,5807,10.68,141789,56653,85136,6.164,15.426,155003,52381,102622,5.699,16.864,-13214,-1.438,30.852,3615,3685,25399
2002,29,104292,131758,2338524,2366102,15678,11.953,14481,11.041,371030,150114,220916,6.344,15.681,424948,142872,282076,6.038,17.96,-53918,-2.279,31.362,8842,9079,71688
2002,30,24275,28359,300256,301911,3249,11.483,3119,11.024,50211,19306,30905,6.395,16.631,53473,18123,35350,6.003,17.712,-3262,-1.08,33.262,1880,1902,9628
2002,31,36607,45141,740235,741203,4583,10.18,4338,9.636,114085,45535,68550,6.143,15.392,116189,35556,80633,4.797,15.676,-2104,-0.284,30.784,2616,2670,17550
2002,32,35539,44136,929579,932223,7025,16.131,5852,13.438,183953,80621,103332,8.648,19.733,190025,62192,127833,6.671,20.384,-6072,-0.651,39.465,3717,3786,28736
2002,33,28418,33933,549006,555896,3555,10.481,3527,10.398,79965,31352,48613,5.64,14.385,93867,29709,64158,5.344,16.886,-13902,-2.501,28.77,2223,2277,16355
2002,34,176363,209436,3578764,3600806,24186,11.562,23677,11.319,608795,220806,387989,6.132,16.907,652454,213304,439150,5.924,18.12,-43659,-1.212,33.814,15015,15287,105630
2002,35,31290,38671,552395,556116,4644,12.029,4516,11.697,98122,39436,58686,7.091,17.644,106100,35189,70911,6.328,19.079,-7978,-1.435,35.288,2637,2696,17487
2002,36,367677,436125,7167801,7258888,50832,11.673,49548,11.378,1176661,491292,685369,6.768,16.21,1360000,510554,849446,7.034,18.736,-183339,-2.526,32.42,31351,31925,234097
2002,37,145672,187017,3322273,3386004,21777,11.677,20744,11.123,508711,211694,297017,6.252,15.024,633413,206991,426422,6.113,18.707,-124702,-3.683,30.048,12518,12884,92567
2002,38,15037,18246,254816,256450,1666,9.128,1676,9.183,36504,16164,20340,6.303,14.234,39694,12675,27019,4.942,15.478,-3190,-1.244,28.469,1024,1043,6453
2002,39,186770,245391,4725250,4815400,24263,9.871,25083,10.205,707186,269171,438015,5.59,14.686,886165,273671,612494,5.683,18.403,-178979,-3.717,29.372,14478,14966,127004
2002,40,62345,77559,1188220,1200168,8869,11.479,8278,10.714,202392,78648,123744,6.553,16.864,226196,82720,143476,6.892,18.847,-23804,-1.983,33.727,5064,5211,39386
2002,41,73548,89842,1324802,1344919,10657,11.868,10561,11.761,211613,80639,130974,5.996,15.734,251737,83582,168155,6.215,18.718,-40124,-2.983,31.469,6488,6634,45580
2002,42,212086,270499,5004029,5049655,26593,9.837,26293,9.726,754417,293907,460510,5.82,14.94,846358,301932,544426,5.979,16.761,-91941,-1.821,29.88,15369,15937,129149
2002,44,22219,25529,417107,416058,2646,10.372,2609,10.227,65306,27509,37797,6.612,15.696,62591,19444,43147,4.673,15.044,2715,0.653,30.088,1622,1638,9979
2002,45,69877,89057,1538257,1573915,10363,11.676,9754,10.99,227458,87608,139850,5.566,14.452,299244,94595,204649,6.01,19.013,-71786,-4.561,28.903,6051,6207,47902
2002,46,18289,21759,300494,306925,2410,11.17,2043,9.469,43471,16474,26997,5.367,14.163,56096,19134,36962,6.234,18.277,-12625,-4.113,28.327,1321,1341,9440
2002,47,90220,119144,2300981,2332289,13291,11.141,13591,11.393,366099,136171,229928,5.839,15.697,429655,141723,287932,6.077,18.422,-63556,-2.725,31.394,8123,8352,63223
2002,48,328350,433932,7946655,8055521,55253,12.805,50403,11.681,1470905,630478,840427,7.827,18.26,1689664,582962,1106702,7.237,20.975,-218759,-2.716,36.519,30286,31395,253671
2002,49,40792,50012,905293,908919,7544,15.269,6333,12.818,165442,65735,99707,7.232,18.202,172427,57566,114861,6.333,18.971,-6985,-0.768,36.404,3801,3874,31212
2002,50,16561,19088,254931,256296,1833,9.567,1978,10.323,37608,14181,23427,5.533,14.674,40207,13523,26684,5.276,15.688,-2599,-1.014,29.347,1193,1219,6493
2002,51,125338,162079,2915268,2934887,19170,11.902,17144,10.644,485094,193711,291383,6.6,16.529,524313,188703,335610,6.43,17.865,-39219,-1.336,33.057,9895,10223,85301
2002,53,118449,145416,2157284,2208558,18187,12.513,18035,12.409,340925,139431,201494,6.313,15.437,444704,140423,304281,6.358,20.135,-103779,-4.699,30.873,11148,11396,75075
2002,54,29403,37027,565157,562881,3625,9.761,3849,10.364,89626,28414,61212,5.048,15.923,85057,26927,58130,4.784,15.111,4569,0.812,30.222,2384,2418,14472
2002,55,102079,127537,2362408,2383567,12762,10.012,12617,9.898,333684,130339,203345,5.468,13.999,377629,113994,263635,4.782,15.843,-43945,-1.844,27.999,7669,7877,57206
2002,56,14129,16370,177778,177848,2051,12.642,1759,10.842,33724,13595,20129,7.644,18.962,33958,12594,21364,7.081,19.094,-234,-0.132,37.925,1080,1091,6092
2003,01,71001,91863,1596004,1587052,9449,10.317,8889,9.706,250499,76765,173734,4.837,15.784,231831,76322,155509,4.809,14.608,18668,1.176,29.215,5790,5866,33445
2003,02,13065,15928,217764,214690,1961,12.436,1642,10.413,40236,14118,26118,6.576,18.741,33754,10165,23589,4.735,15.722,6482,3.019,31.444,944,967,4882
2003,04,83669,106905,1973006,1950434,14296,13.496,12336,11.646,385066,138000,247066,7.075,19.743,342248,130939,211309,6.713,17.547,42818,2.195,35.095,7674,7801,51973
2003,05,46508,58228,979580,974451,6395,11.066,5520,9.552,140409,45881,94528,4.708,14.409,130205,40800,89405,4.187,13.362,10204,1.047,26.724,3698,3763,17810
2003,06,587486,729432,12773021,12697660,89947,12.406,81093,11.185,2240193,762067,1478126,6.002,17.643,2086534,703694,1382840,5.542,16.432,153659,1.21,32.865,51401,53086,357852
2003,08,102325,124298,1890092,1900558,16445,13.323,14714,11.921,313389,119652,193737,6.296,16.489,334238,118233,216005,6.221,17.586,-20849,-1.097,32.979,9035,9182,54955
2003,09,68271,82560,1537847,1537917,7403,8.936,7966,9.616,216037,66338,149699,4.313,14.047,216199,69799,146400,4.539,14.058,-162,-0.011,28.095,4765,4837,28053
2003,10,17784,21859,380849,382185,2399,11.052,2092,9.638,51166,17308,33858,4.529,13.388,54244,18581,35663,4.862,14.193,-3078,-0.805,26.776,1257,1280,7386
2003,11,14613,18014,413440,413485,1712,9.49,1764,9.778,55625,17422,38203,4.213,13.453,55633,17692,37941,4.279,13.455,-8,-0.002,26.905,925,934,5176
2003,12,322958,400530,6419213,6348250,58672,14.846,48005,12.147,1225702,443531,782171,6.987,19.308,1082571,431672,650899,6.8,17.053,143131,2.255,34.106,31241,31781,190773
2003,13,144271,185176,3346431,3354358,23851,12.991,20694,11.271,527141,193807,333334,5.778,15.715,543315,184082,359233,5.488,16.197,-16174,-0.482,31.43,12539,12842,76250
2003,15,22639,28226,457983,448591,2878,10.269,2480,8.849,70525,21294,49231,4.747,15.721,51404,19812,31592,4.417,11.459,19121,4.262,22.918,1491,1540,10168
2003,16,29041,34601,464247,458311,4592,13.476,3539,10.386,77348,26721,50627,5.83,16.877,66106,21892,44214,4.777,14.424,11242,2.453,28.848,2231,2272,10283
2003,17,220112,275086,5180256,5172514,28320,10.328,26553,9.684,755768,240537,515231,4.65,14.611,740233,248404,491829,4.802,14.311,15535,0.3,28.622,16023,16377,111096
2003,18,103615,134277,2538144,2534109,12836,9.577,12333,9.202,367108,113661,253447,4.485,14.487,358235,126758,231477,5.002,14.137,8873,0.35,28.273,7589,7831,50786
2003,19,57598,73040,1226487,1226976,6726,9.226,6457,8.857,154313,52880,101433,4.31,12.577,155329,47075,108254,3.837,12.659,-1016,-0.083,25.153,3756,3843,20260
2003,20,54286,68000,1107528,1104087,6795,10.018,6450,9.509,159370,59058,100312,5.349,14.435,152549,49943,102606,4.523,13.817,6821,0.618,27.634,3981,4067,23652
2003,21,64530,82933,1461790,1460655,7942,9.592,7665,9.258,205791,68047,137744,4.659,14.089,204806,65149,139657,4.46,14.022,985,0.067,28.043,4880,5021,30172
2003,22,73716,93306,1594224,1584097,9218,9.91,8634,9.282,248564,79486,169078,5.018,15.691,228071,74440,153631,4.699,14.398,20493,1.294,28.795,5463,5571,38510
2003,23,29477,35288,488394,487509,3618,10.306,3254,9.269,67145,23029,44116,4.724,13.773,65628,22220,43408,4.558,13.462,1517,0.311,26.924,2046,2094,11428
2003,24,95372,118472,2076987,2068225,12864,10.931,11288,9.592,310079,101614,208465,4.913,14.993,293253,88432,204821,4.276,14.179,16826,0.814,28.358,6686,6861,38150
2003,25,128742,157712,2963817,2975139,16877,10.771,14840,9.471,418753,130816,287937,4.397,14.075,442368,157682,284686,5.3,14.869,-23615,-0.794,28.15,8729,8895,56877
2003,26,165864,209991,3841949,3853238,21150,10.081,20781,9.905,570805,190637,380168,4.947,14.814,594546,184136,410410,4.779,15.43,-23741,-0.616,29.627,12746,13143,89286
2003,27,101376,126143,2361838,2353552,13762,10.99,11913,9.514,347928,124420,223508,5.286,14.783,331585,106135,225450,4.51,14.089,16343,0.694,28.177,7061,7164,41297
2003,28,43229,54976,916053,914203,5771,10.538,5349,9.767,139556,49081,90475,5.369,15.265,136122,44834,91288,4.904,14.89,3434,0.376,29.779,3448,3495,21097
2003,29,105902,133566,2371841,2354885,15162,11.432,13282,10.015,342967,101863,241104,4.326,14.564,309691,102723,206968,4.362,13.151,33276,1.413,26.302,8540,8765,48376
2003,30,24889,29009,304517,302308,3370,11.752,2705,9.433,47263,16847,30416,5.573,15.634,42919,13721,29198,4.539,14.197,4344,1.437,28.394,1703,1719,7529
2003,31,36956,45629,757231,748660,4409,9.717,3895,8.585,115811,35883,79928,4.793,15.469,98875,30734,68141,4.105,13.207,16936,2.262,26.414,2378,2417,12128
2003,32,37130,45979,968798,949957,7324,16.26,5453,12.106,173889,60301,113588,6.348,18.305,136184,44954,91230,4.732,14.336,37705,3.969,28.672,3507,3553,23291
2003,33,28526,34109,541462,545120,3473,10.21,3288,9.666,74226,25321,48905,4.645,13.616,80997,23780,57217,4.362,14.859,-6771,-1.242,27.233,2137,2179,12512
2003,34,176982,210140,3564025,3570397,23237,11.078,22463,10.709,552308,177736,374572,4.978,15.469,565330,189606,375724,5.311,15.834,-13022,-0.365,30.938,14412,14620,90583
2003,35,31723,39124,571994,562049,4415,11.352,3948,10.152,99456,36787,62669,6.545,17.695,80055,29764,50291,5.296,14.243,19401,3.452,28.487,2330,2383,13142
2003,36,372603,440868,7262199,7209590,49061,11.191,44133,10.067,1100708,344461,756247,4.778,15.267,994117,323521,670596,4.487,13.789,106591,1.478,27.578,29062,29550,158494
2003,37,146906,188662,3339460,3331250,20828,11.09,19126,10.184,511709,178824,332885,5.368,15.361,496663,165163,331500,4.958,14.909,15046,0.452,29.818,11660,11874,67490
2003,38,15099,18279,260579,257568,1481,8.112,1438,7.876,35230,9677,25553,3.757,13.678,29237,9582,19655,3.72,11.351,5993,2.327,22.702,865,870,4672
2003,39,186527,245238,4739697,4734387,22582,9.207,22648,9.234,668250,210377,457873,4.444,14.115,659827,201765,458062,4.262,13.937,8423,0.178,27.874,13322,13751,87382
2003,40,62700,78010,1171765,1180319,8116,10.438,7610,9.787,174665,57567,117098,4.877,14.798,191897,59397,132500,5.032,16.258,-17232,-1.46,29.596,4998,5050,29092
2003,41,74896,91277,1330468,1326430,10697,11.816,9196,10.158,204938,61626,143312,4.646,15.45,197441,68977,128464,5.2,14.885,7497,0.565,29.77,5626,5722,29142
2003,42,212620,271589,4978669,4989850,25004,9.227,23796,8.781,690001,221556,468445,4.44,13.828,713947,227001,486946,4.549,14.308,-23946,-0.48,27.656,14306,14757,92721
2003,44,22472,25774,420840,418752,2672,10.42,2411,9.402,59138,18357,40781,4.384,14.122,54534,17095,37439,4.082,13.023,4604,1.099,26.046,1439,1484,7553
2003,45,70870,90239,1546976,1542592,10039,11.2,8831,9.852,238498,91979,146519,5.963,15.461,230571,81319,149252,5.272,14.947,7927,0.514,29.894,5576,5662,36430
2003,46,18432,21818,302772,301785,2102,9.651,2028,9.311,41322,12738,28584,4.221,13.693,39256,14127,25129,4.681,13.008,2066,0.685,26.016,1224,1242,6359
2003,47,90519,119585,2296796,2298406,12726,10.664,12239,10.255,350080,128003,222077,5.569,15.231,353510,115261,238249,5.015,15.381,-3430,-0.149,30.463,7449,7666,46545
2003,48,332098,437837,7974475,7967148,52047,11.944,47913,10.995,1377691,499868,877823,6.274,17.292,1360352,498649,861703,6.259,17.075,17339,0.218,34.149,29243,30036,208282
2003,49,42255,51485,900041,902035,7684,15.144,6193,12.205,152713,61636,91077,6.833,16.93,155640,57703,97937,6.397,17.254,-2927,-0.324,33.86,3851,3929,27789
2003,50,16648,19263,252411,253598,1844,9.621,1650,8.609,33079,9854,23225,3.886,13.044,35704,12948,22756,5.106,14.079,-2625,-1.035,26.088,1031,1054,6212
2003,51,127421,164597,2922109,2917377,18528,11.346,15935,9.758,437407,147965,289442,5.072,14.993,429646,146794,282852,5.032,14.727,7761,0.266,29.454,9286,9603,56567
2003,53,120234,147114,2203714,2193171,17846,12.204,16073,10.992,353655,113793,239862,5.189,16.125,333627,112404,221223,5.125,15.212,20028,0.913,30.424,9846,10004,47585
2003,54,29239,36977,562934,563879,3458,9.349,3479,9.406,78799,29649,49150,5.258,13.974,80159,24323,55836,4.314,14.216,-1360,-0.241,27.949,2124,2255,13386
2003,55,102047,127778,2385324,2372923,11624,9.108,11320,8.87,316244,103092,213152,4.345,13.327,291240,86988,204252,3.666,12.273,25004,1.054,24.547,6999,7117,39111
2003,56,14340,16592,181809,179791,1884,11.432,1661,10.079,31267,9906,21361,5.51,17.391,27219,9273,17946,5.158,15.139,4048,2.252,30.278,1051,1072,5048
2004,01,71878,92921,1636237,1616007,9564,10.352,8504,9.204,252279,82198,170081,5.086,15.611,212945,71975,140970,4.454,13.177,39334,2.434,26.354,5516,5592,35085
2004,02,13397,16270,223644,220674,1948,12.1,1607,9.982,35327,9857,25470,4.467,16.009,29471,10745,18726,4.869,13.355,5856,2.654,26.71,973,1006,4843
2004,04,86209,110121,2032755,2001425,14750,13.59,11578,10.668,364412,130462,233950,6.518,18.208,301134,119627,181507,5.977,15.046,63278,3.162,30.092,7268,7480,47976
2004,05,47148,59013,993772,986921,6219,10.609,5436,9.273,143742,46641,97101,4.726,14.565,130766,45636,85130,4.624,13.25,12976,1.315,26.5,3736,3796,20214
2004,06,596383,739366,12966161,12872668,89936,12.245,80176,10.916,2140432,721577,1418855,5.605,16.628,1964573,718469,1246104,5.581,15.262,175859,1.366,30.523,51708,53225,363883
2004,08,104208,126617,1909414,1898702,16524,13.17,14221,11.335,303091,114485,188606,6.03,15.963,282411,102621,179790,5.405,14.874,20680,1.089,29.748,9054,9201,51131
2004,09,68865,83518,1532968,1536049,7973,9.6,7044,8.481,203581,67822,135759,4.415,13.254,209642,72339,137303,4.709,13.648,-6061,-0.395,26.507,4439,4494,24910
2004,10,18154,22406,391113,386091,2607,11.782,2048,9.256,60703,23779,36924,6.159,15.722,50487,19907,30580,5.156,13.076,10216,2.646,26.153,1263,1285,7431
2004,11,14889,18431,421766,421524,2094,11.488,1687,9.255,58061,19954,38107,4.734,13.774,57337,14720,42617,3.492,13.602,724,0.172,27.205,954,985,6238
2004,12,339905,419346,6625496,6556188,65790,16.047,47064,11.48,1243552,439051,804501,6.697,18.968,1113265,453391,659874,6.915,16.98,130287,1.987,33.961,31171,31914,205278
2004,13,148394,189986,3420305,3386665,23976,12.781,19196,10.233,558948,193226,365722,5.705,16.504,492464,169508,322956,5.005,14.541,66484,1.963,29.083,12183,12396,73924
2004,15,23113,28809,471720,464805,2878,10.091,2303,8.075,63792,20044,43748,4.312,13.724,50317,15156,35161,3.261,10.825,13475,2.899,21.651,1489,1526,8286
2004,16,30149,35780,484149,474182,4640,13.186,3457,9.824,84344,38725,45619,8.167,17.787,64104,22786,41318,4.805,13.519,20240,4.268,27.038,2152,2179,11543
2004,17,223009,278251,5206097,5194471,28851,10.428,25702,9.29,727700,225822,501878,4.347,14.009,702693,225964,476729,4.35,13.528,25007,0.481,27.055,15839,16557,106112
2004,18,104711,136006,2581316,2560033,13276,9.823,11557,8.551,354274,114127,240147,4.458,13.839,310428,98448,211980,3.846,12.126,43846,1.713,24.252,7521,7779,50268
2004,19,58012,73479,1240557,1233256,6453,8.808,6023,8.221,157822,45516,112306,3.691,12.797,142812,47182,95630,3.826,11.58,15010,1.217,23.16,3842,3924,21102
2004,20,55004,68735,1112143,1109642,6856,10.031,6089,8.908,144719,50345,94374,4.537,13.042,140313,44523,95790,4.012,12.645,4406,0.397,25.29,3877,3962,21987
2004,21,65164,83703,1482566,1473917,8082,9.7,7314,8.778,204373,65976,138397,4.476,13.866,186795,65933,120862,4.473,12.673,17578,1.193,25.347,4697,4847,33961
2004,22,74533,94239,1613823,1604923,9145,9.753,8201,8.746,235971,69247,166724,4.315,14.703,218581,65917,152664,4.107,13.619,17390,1.084,27.239,5312,5436,35042
2004,23,29943,35803,495083,491581,3658,10.291,3145,8.848,61233,19227,42006,3.911,12.456,54206,18450,35756,3.753,11.027,7027,1.429,22.054,2121,2157,11355
2004,24,97588,120902,2142444,2111311,13359,11.161,10950,9.148,326971,106090,220881,5.025,15.487,264141,95141,169000,4.506,12.511,62830,2.976,25.022,6794,6917,40945
2004,25,127613,156814,2970580,2968908,15546,9.884,16486,10.482,383782,129711,254071,4.369,12.927,381568,122790,258778,4.136,12.852,2214,0.075,25.704,11491,11650,59755
2004,26,166949,210603,3855031,3847809,20879,9.927,20319,9.661,540563,189124,351439,4.915,14.049,527684,183927,343757,4.78,13.714,12879,0.335,27.428,12429,13038,91820
2004,27,103358,128491,2374930,2369620,13824,10.857,11503,9.034,310326,96157,214169,4.058,13.096,299886,101547,198339,4.285,12.655,10440,0.441,25.311,7138,7308,44183
2004,28,43644,55579,930497,923380,5610,10.148,5012,9.067,134190,45806,88384,4.961,14.532,119287,40173,79114,4.351,12.919,14903,1.614,25.837,3341,3400,18925
2004,29,108424,136463,2399820,2387059,15893,11.771,13007,9.633,343689,119911,223778,5.023,14.398,318630,113490,205140,4.754,13.348,25059,1.05,26.696,8666,8787,48820
2004,30,25753,29879,315002,309702,3663,12.443,2783,9.453,48642,16049,32593,5.182,15.706,37811,15215,22596,4.913,12.209,10831,3.497,24.418,1750,1781,8337
2004,31,37331,46004,754890,755839,4178,9.119,3806,8.307,93839,32204,61635,4.261,12.415,95334,24985,70349,3.306,12.613,-1495,-0.198,24.83,2423,2482,13102
2004,32,38691,47830,1020662,995107,7537,16.091,5556,11.862,183567,66598,116969,6.693,18.447,132516,51811,80705,5.207,13.317,51051,5.13,26.634,3588,3692,26641
2004,33,29036,34743,550725,546263,3650,10.602,3020,8.772,69162,22248,46914,4.073,12.661,60623,20263,40360,3.709,11.098,8539,1.563,22.196,2006,2055,11456
2004,34,179494,211731,3609189,3591824,23796,11.279,22284,10.562,556874,172231,384643,4.795,15.504,524248,193866,330382,5.397,14.596,32626,0.908,29.191,14037,14201,83812
2004,35,32273,39731,582530,577201,4400,11.16,3791,9.615,91842,31303,60539,5.423,15.912,81125,29276,51849,5.072,14.055,10717,1.857,28.11,2395,2426,12505
2004,36,377760,446855,7351972,7326238,51231,11.541,45359,10.218,1055759,343078,712681,4.683,14.411,1004791,331902,672889,4.53,13.715,50968,0.696,27.43,29961,30401,166704
2004,37,150095,192307,3358009,3346037,21340,11.202,17726,9.305,491044,161392,329652,4.823,14.675,470089,158640,311449,4.741,14.049,20955,0.626,28.098,11165,11416,71419
2004,38,15379,18571,263807,262162,1634,8.87,1337,7.257,33346,10340,23006,3.944,12.72,30295,13096,17199,4.995,11.556,3051,1.164,23.112,869,875,4609
2004,39,187075,246270,4721444,4731123,22351,9.094,21362,8.692,610528,197283,413245,4.17,12.905,630356,223165,407191,4.717,13.324,-19828,-0.419,25.809,13152,13642,99159
2004,40,63616,79135,1185013,1178565,8290,10.55,7173,9.129,177840,59536,118304,5.052,15.09,165128,54264,110864,4.604,14.011,12712,1.079,28.022,4685,4797,27230
2004,41,76334,93018,1348082,1340039,10655,11.562,8931,9.691,189908,66232,123676,4.943,14.172,173982,64115,109867,4.785,12.983,15926,1.188,25.967,5749,5849,31293
2004,42,215091,274176,5041842,5013844,25194,9.232,22646,8.298,670509,204292,466217,4.075,13.373,615913,208572,407341,4.16,12.284,54596,1.089,24.568,14109,14411,88851
2004,44,23083,26503,434801,428414,2898,11.086,2174,8.316,61493,18790,42703,4.386,14.354,48989,15531,33458,3.625,11.435,12504,2.919,22.87,1456,1463,7770
2004,45,72303,92054,1566070,1559333,10177,11.165,8371,9.184,223972,77825,146147,4.991,14.363,211624,69356,142268,4.448,13.571,12348,0.792,27.143,5468,5571,34345
2004,46,18774,22212,312014,307166,2202,10.001,1814,8.239,46252,15076,31176,4.908,15.058,36536,13429,23107,4.372,11.895,9716,3.163,23.789,1167,1174,5017
2004,47,92135,121508,2336083,2317696,12792,10.611,10895,9.037,342417,113404,229013,4.893,14.774,306232,104076,202156,4.49,13.213,36185,1.561,26.426,6941,7143,44145
2004,48,337169,444891,8082359,8030537,52747,11.95,45757,10.366,1347911,503002,844909,6.264,16.785,1250669,445230,805439,5.544,15.574,97242,1.211,31.148,29234,30045,201599
2004,49,44011,53432,919613,908935,7862,14.985,5927,11.297,170925,63018,107907,6.933,18.805,149240,64538,84702,7.1,16.419,21685,2.386,32.838,3752,3797,22923
2004,50,16904,19531,252750,252888,1847,9.522,1581,8.15,27369,9287,18082,3.672,10.823,27814,7669,20145,3.033,10.999,-445,-0.176,21.645,1027,1040,4570
2004,51,131589,169615,3033281,2980125,19561,11.704,14584,8.726,478876,156609,322267,5.255,16.069,371524,119560,251964,4.012,12.467,107352,3.602,24.933,8961,9130,53272
2004,53,122896,150372,2254100,2230629,18208,12.24,14982,10.071,334107,107998,226109,4.842,14.978,288389,90776,197613,4.07,12.929,45718,2.05,25.857,9611,9794,49020
2004,54,29576,37430,568391,565434,3555,9.557,3094,8.317,74113,22480,51633,3.976,13.107,68867,23159,45708,4.096,12.179,5246,0.928,24.359,2019,2075,10430
2004,55,103151,129259,2428765,2407186,11619,9.04,10145,7.894,313360,96046,217314,3.99,13.018,269212,89264,179948,3.708,11.184,44148,1.834,22.367,6505,6730,38727
2004,56,14641,16918,188722,185287,1883,11.237,1560,9.31,30499,9131,21368,4.928,16.46,23670,8405,15265,4.536,12.775,6829,3.686,25.55,973,979,4260
2005,01,72514,94119,1676485,1656783,9666,10.337,8440,9.026,263667,82561,181106,4.983,15.914,225560,65921,159639,3.979,13.614,38107,2.3,27.229,5580,5686,31363
2005,02,13570,16561,226985,223562,1883,11.476,1577,9.611,35679,10809,24870,4.835,15.959,28782,7543,21239,3.374,12.874,6897,3.085,25.749,1001,1031,4824
2005,04,89392,114690,2155061,2094325,16228,14.435,11683,10.393,410908,160493,250415,7.663,19.62,290500,99568,190932,4.754,13.871,120408,5.749,27.742,7442,7686,48200
2005,05,47516,59869,1011684,1002843,6378,10.73,5523,9.291,137523,47078,90445,4.694,13.713,120061,36474,83587,3.637,11.972,17462,1.741,23.944,3912,3965,21857
2005,06,607440,754590,13152091,13067337,94833,12.695,79626,10.66,2082877,749604,1333273,5.736,15.94,1908573,620372,1288201,4.748,14.606,174304,1.334,29.211,53211,54526,340318
2005,08,106973,129997,1932184,1921722,17553,13.68,14182,11.053,298475,112751,185724,5.867,15.532,277503,95998,181505,4.995,14.44,20972,1.091,28.881,9054,9204,48065
2005,09,69230,84087,1524476,1528493,8104,9.67,7538,8.995,184472,72219,112253,4.725,12.069,191576,60203,131373,3.939,12.534,-7104,-0.465,24.138,4611,4675,27297
2005,10,18329,22502,391754,390883,2393,10.659,2288,10.192,55461,18332,37129,4.69,14.189,53650,22956,30694,5.873,13.725,1811,0.463,27.451,1310,1328,9150
2005,11,15006,18612,425487,423627,1867,10.081,1684,9.093,54464,18333,36131,4.328,12.857,51239,14416,36823,3.403,12.095,3225,0.761,24.191,902,924,6153
2005,12,355048,437036,6800001,6714695,67491,15.761,49837,11.638,1228326,484449,743877,7.215,18.293,1058003,392780,665223,5.85,15.757,170323,2.537,31.513,32762,33285,215385
2005,13,152124,194728,3473114,3448612,24821,12.902,20113,10.455,544117,199911,344206,5.797,15.778,496433,167800,328633,4.866,14.395,47684,1.383,28.79,12762,13023,77644
2005,15,23547,29463,486948,479347,2999,10.292,2353,8.075,71362,26516,44846,5.532,14.887,56029,17858,38171,3.725,11.689,15333,3.199,23.377,1481,1541,8034
2005,16,31714,37561,513011,498900,5251,14.32,3469,9.46,91419,35731,55688,7.162,18.324,62866,19760,43106,3.961,12.601,28553,5.723,25.202,2252,2286,12989
2005,17,225367,281537,5212856,5208964,30130,10.765,26847,9.592,709594,255690,453904,4.909,13.623,700966,225887,475079,4.337,13.457,8628,0.166,26.914,16695,17108,112906
2005,18,104854,136547,2600312,2590994,12967,9.516,12413,9.109,338899,115873,223026,4.472,13.08,321103,101497,219606,3.917,12.393,17796,0.687,24.786,7963,8209,51820
2005,19,58351,74047,1263773,1252225,6494,8.804,5929,8.038,155840,50491,105349,4.032,12.445,133027,38926,94101,3.109,10.623,22813,1.822,21.247,3941,4026,20296
2005,20,55426,69400,1122338,1117740,6723,9.734,6054,8.766,151140,50388,100752,4.508,13.522,141776,47430,94346,4.243,12.684,9364,0.838,25.368,3998,4086,21817
2005,21,65579,84499,1508449,1497143,8241,9.798,7454,8.863,212051,67740,144311,4.525,14.164,189108,54692,134416,3.653,12.631,22943,1.532,25.263,4947,5054,28555
2005,22,74715,94718,1605798,1610185,9176,9.713,8689,9.197,238261,73601,164660,4.571,14.797,246197,87794,158403,5.452,15.29,-7936,-0.493,29.594,5636,5808,42301
2005,23,30293,36327,498082,496614,3719,10.311,3201,8.875,62434,21631,40803,4.356,12.572,59509,17498,42011,3.523,11.983,2925,0.589,23.966,2099,2117,9686
2005,24,99467,123196,2164327,2156507,13810,11.314,11536,9.451,306922,110993,195929,5.147,14.232,291273,93221,198052,4.323,13.507,15649,0.726,27.013,7108,7226,46734
2005,25,126897,156672,2989981,2981494,15245,9.726,15400,9.825,376974,125162,251812,4.198,12.644,358730,121427,237303,4.073,12.032,18244,0.612,24.064,10164,10326,54813
2005,26,167131,211088,3768231,3811038,20867,9.897,20388,9.67,503315,186866,316449,4.903,13.207,587739,163543,424196,4.291,15.422,-84424,-2.215,26.414,13045,13320,84090
2005,27,104776,130384,2413425,2394063,13502,10.432,11597,8.96,319304,109724,209580,4.583,13.337,279954,84105,195849,3.513,11.694,39350,1.644,23.387,7333,7433,42219
2005,28,43675,55846,925578,928265,5660,10.16,5387,9.67,124545,42335,82210,4.561,13.417,129702,42422,87280,4.57,13.973,-5157,-0.556,26.834,3494,3568,22067
2005,29,110341,139097,2392348,2396014,15947,11.575,13302,9.655,306474,110791,195683,4.624,12.791,314694,87342,227352,3.645,13.134,-8220,-0.343,25.582,9122,9287,50021
2005,30,26476,30722,326476,320656,3602,11.887,2761,9.112,51910,21059,30851,6.567,16.189,40314,11655,28659,3.635,12.572,11596,3.616,25.145,1802,1828,7272
2005,31,37652,46489,769722,762940,4260,9.21,3786,8.186,102816,30489,72327,3.996,13.476,89393,25799,63594,3.382,11.717,13423,1.759,23.434,2446,2502,13073
2005,32,40302,49903,1081268,1050899,7864,16.117,5645,11.569,199804,70178,129626,6.678,19.013,139144,55252,83892,5.258,13.24,60660,5.772,26.481,3756,3837,28978
2005,33,29354,35248,552347,551295,3666,10.475,3164,9.041,70710,26406,44304,4.79,12.826,68293,20503,47790,3.719,12.388,2417,0.438,24.775,2165,2187,12741
2005,34,181344,214012,3582420,3597281,24551,11.532,22306,10.478,504162,179517,324645,4.99,14.015,534206,192575,341631,5.353,14.85,-30044,-0.835,28.03,14672,14859,86896
2005,35,32760,40492,597340,589501,4505,11.233,3731,9.303,98243,33685,64558,5.714,16.665,82497,24635,57862,4.179,13.994,15746,2.671,27.989,2398,2452,14863
2005,36,382356,450212,7334874,7346003,50166,11.184,46843,10.443,991322,361001,630321,4.914,13.495,1014014,330213,683801,4.495,13.804,-22692,-0.309,26.989,30660,31060,170431
2005,37,153291,196200,3396502,3376924,22332,11.497,18421,9.483,502760,182581,320179,5.407,14.888,464979,143083,321896,4.237,13.769,37781,1.119,27.539,11829,12127,70692
2005,38,15549,18836,271868,267791,1710,9.147,1429,7.644,34965,11005,23960,4.11,13.057,26782,7521,19261,2.809,10.001,8183,3.056,20.002,946,957,4483
2005,39,186776,246923,4731467,4726671,22438,9.099,21799,8.84,642495,221695,420800,4.69,13.593,632003,191087,440916,4.043,13.371,10492,0.222,26.742,13796,14135,93151
2005,40,64346,80369,1212696,1199465,8655,10.854,7403,9.284,180875,67410,113465,5.62,15.08,154842,50595,104247,4.218,12.909,26033,2.17,25.819,5009,5110,29405
2005,41,78688,95772,1398394,1373366,11694,12.388,8952,9.483,211711,75474,136237,5.496,15.415,161497,54669,106828,3.981,11.759,50214,3.656,23.518,5718,5871,28763
2005,42,216453,276683,5065897,5064734,26256,9.533,23756,8.625,642019,230254,411765,4.546,12.676,638952,191053,447899,3.772,12.616,3067,0.061,25.231,15094,15462,85922
2005,44,23203,26736,440270,438148,2721,10.221,2491,9.357,53398,19455,33943,4.44,12.187,49098,14402,34696,3.287,11.206,4300,0.981,22.412,1620,1628,8115
2005,45,73825,94228,1591319,1578765,10813,11.61,8629,9.265,233111,85044,148067,5.387,14.765,207948,63042,144906,3.993,13.172,25163,1.594,26.343,5737,5846,33993
2005,46,19086,22554,317213,314670,2199,9.824,1859,8.305,40453,10923,29530,3.471,12.856,35568,10681,24887,3.394,11.303,4885,1.552,22.607,1199,1218,5485
2005,47,92919,122959,2356204,2346214,13031,10.661,11575,9.47,331556,108810,222746,4.638,14.132,311358,91944,219414,3.919,13.271,20198,0.861,26.541,7491,7701,46442
2005,48,342012,452720,8237722,8165157,53395,11.897,45567,10.153,1339563,499190,840373,6.114,16.406,1196281,389775,806506,4.774,14.651,143282,1.755,29.302,29427,30206,197632
2005,49,45933,55618,960195,940222,8311,15.242,6131,11.244,175011,59672,115339,6.347,18.614,134436,48044,86392,5.11,14.298,40575,4.315,28.597,3885,3962,24116
2005,50,17027,19713,258958,255973,1840,9.375,1667,8.494,33827,10749,23078,4.199,13.215,27653,8505,19148,3.323,10.803,6174,2.412,21.606,1087,1099,5261
2005,51,134722,173352,3059581,3045856,19690,11.481,15981,9.319,445330,157129,288201,5.159,14.621,417274,125893,291381,4.133,13.7,28056,0.921,27.399,9884,10173,54563
2005,53,126447,154546,2317929,2289589,19617,12.867,15437,10.126,357335,123203,234132,5.381,15.607,299887,99707,200180,4.355,13.098,57448,2.509,26.196,9803,10020,49248
2005,54,29570,37568,568753,568529,3567,9.513,3426,9.137,75559,24553,51006,4.319,13.29,74987,22340,52647,3.929,13.19,572,0.101,26.379,2262,2289,10621
2005,55,104222,130773,2445367,2434249,12034,9.256,10516,8.088,303243,95758,207485,3.934,12.457,280402,82416,197986,3.386,11.519,22841,0.938,23.038,6879,7074,40922
2005,56,14988,17353,193900,191631,2048,11.951,1614,9.419,31373,10729,20644,5.599,16.372,26697,7987,18710,4.168,13.931,4676,2.44,27.863,1086,1094,4982
2006,01,73360,96098,1709661,1692850,10664,11.213,8681,9.128,265584,102207,163377,6.038,15.689,232270,72608,159662,4.289,13.721,33314,1.968,27.441,5865,5984,34870
2006,02,13799,16995,241658,235946,2141,12.761,1706,10.168,40383,10883,29500,4.613,17.115,29179,8739,20440,3.704,12.367,11204,4.749,24.734,1113,1134,4966
2006,04,94663,122105,2335897,2247945,19317,16.317,11880,10.035,455884,173949,281935,7.738,20.28,279327,96032,183295,4.272,12.426,176557,7.854,24.852,7919,8092,52827
2006,05,47870,61048,1041986,1026811,7046,11.655,5857,9.688,146173,51853,94320,5.05,14.236,115644,34916,80728,3.4,11.262,30529,2.973,22.525,4141,4225,20717
2006,06,625085,779562,13708685,13457434,104787,13.662,79622,10.381,2334463,851460,1483003,6.327,17.347,1831821,601811,1230010,4.472,13.612,502642,3.735,27.224,54842,55906,324517
2006,08,110056,134401,2018809,1976300,19189,14.515,14784,11.183,347661,135858,211803,6.874,17.592,263035,93999,169036,4.756,13.309,84626,4.282,26.619,9646,9790,49687
2006,09,69422,85037,1545414,1533611,8722,10.315,7764,9.182,206579,73706,132873,4.806,13.47,182394,63246,119148,4.124,11.893,24185,1.577,23.786,5230,5333,29823
2006,10,18354,22673,388244,389204,2624,11.614,2466,10.914,54894,19823,35071,5.093,14.104,56958,20998,35960,5.395,14.634,-2064,-0.53,28.208,1634,1670,7846
2006,11,15317,19160,435087,430317,2205,11.677,1652,8.748,62527,20675,41852,4.805,14.53,52672,15724,36948,3.654,12.24,9855,2.29,24.481,924,935,6098
2006,12,369714,455647,7164029,6983218,70885,15.882,52229,11.702,1302454,494404,808050,7.08,18.651,947190,355273,591917,5.088,13.564,355264,5.087,27.128,35827,36362,199535
2006,13,157066,201534,3606338,3542489,27323,13.791,20511,10.352,599561,229058,370503,6.466,16.925,474201,167110,307091,4.717,13.386,125360,3.539,26.772,13387,13643,81636
2006,15,24167,30512,510377,498635,3381,11.274,2335,7.786,76071,27952,48119,5.606,15.256,52389,14891,37498,2.986,10.506,23682,4.749,21.013,1540,1569,8115
2006,16,33813,40016,541550,527821,6254,16.126,3786,9.762,94815,34757,60058,6.585,17.963,67658,24684,42974,4.677,12.818,27157,5.145,25.637,2598,2627,17221
2006,17,228414,286723,5341164,5281240,32361,11.39,27135,9.551,785495,278394,507101,5.271,14.873,667297,227501,439796,4.308,12.635,118198,2.238,25.27,17575,17921,117077
2006,18,105862,138931,2654252,2629250,14753,10.711,12369,8.98,365133,126942,238191,4.828,13.887,314637,96652,217985,3.676,11.967,50496,1.921,23.934,8073,8247,47920
2006,19,58283,75034,1294592,1279452,7668,10.287,6681,8.963,167354,57288,110066,4.478,13.08,136685,41403,95282,3.236,10.683,30669,2.397,21.366,4550,4647,20774
2006,20,55587,70047,1157518,1142495,7404,10.621,6734,9.66,163871,56545,107326,4.949,14.343,133371,41963,91408,3.673,11.674,30500,2.67,23.347,4508,4607,21860
2006,21,65949,85715,1545074,1526512,8818,10.362,7581,8.909,218047,73289,144758,4.801,14.284,181536,56239,125297,3.684,11.892,36511,2.392,23.784,5163,5254,28791
2006,22,72030,92454,1585306,1595923,10335,11.044,12580,13.444,273808,97166,176642,6.088,17.157,296893,99254,197639,6.219,18.603,-23085,-1.446,34.313,7421,7581,44578
2006,23,30655,37046,506042,502396,4223,11.512,3501,9.543,65921,25570,40351,5.09,13.121,58644,18625,40019,3.707,11.673,7277,1.448,23.346,2482,2507,10785
2006,24,101589,126445,2232391,2198406,15076,12.078,11833,9.48,345142,123667,221475,5.625,15.7,277686,94532,183154,4.3,12.631,67456,3.068,25.262,7700,7835,43686
2006,25,128542,159388,3062860,3027752,16921,10.708,14175,8.971,435538,148287,287251,4.898,14.385,367530,117402,250128,3.878,12.139,68008,2.246,24.277,9322,9477,58582
2006,26,167333,212780,3774312,3765433,22400,10.569,20703,9.769,525444,180978,344466,4.806,13.954,508219,157375,350844,4.179,13.497,17225,0.457,26.994,14133,14368,81341
2006,27,106156,133238,2467344,2440972,15410,11.691,12558,9.527,342798,117756,225042,4.824,14.044,289277,92027,197250,3.77,11.851,53521,2.193,23.702,8321,8464,47384
2006,28,43363,55967,945184,936288,6235,11.152,6115,10.938,146592,53413,93179,5.705,15.657,129445,41045,88400,4.384,13.825,17147,1.831,27.651,3915,3988,20728
2006,29,109771,140079,2441595,2416570,16291,11.673,15266,10.938,354483,128934,225549,5.335,14.669,303041,97936,205105,4.053,12.54,51442,2.129,25.08,10849,11057,50482
2006,30,27520,32011,337849,332573,4296,13.697,3005,9.581,55068,20687,34381,6.22,16.558,44376,13547,30829,4.073,13.343,10692,3.215,26.686,2029,2054,8462
2006,31,37828,47131,784096,777148,4822,10.302,4177,8.924,101465,39235,62230,5.049,13.056,87056,26213,60843,3.373,11.202,14409,1.854,22.404,2810,2876,13777
2006,32,42511,52972,1157976,1120626,8864,17.236,5772,11.224,217448,81425,136023,7.266,19.404,145154,44994,100160,4.015,12.953,72294,6.451,25.906,4010,4061,25004
2006,33,29575,35741,571505,562312,3879,10.929,3382,9.529,84205,28106,56099,4.998,14.975,65732,20874,44858,3.712,11.69,18473,3.285,23.379,2363,2399,10836
2006,34,183960,218262,3663218,3624794,26376,12.204,22112,10.231,560308,206899,353409,5.708,15.458,482816,159408,323408,4.398,13.32,77492,2.138,26.64,15402,15549,77859
2006,35,33541,41630,631176,614146,5125,12.481,3989,9.715,111435,39825,71610,6.485,18.145,77158,27158,50000,4.422,12.563,34277,5.581,25.127,2648,2684,14733
2006,36,386200,456984,7483339,7417086,53495,11.794,46700,10.296,1062746,373536,689210,5.036,14.328,929555,299965,629590,4.044,12.533,133191,1.796,25.065,33367,33744,173777
2006,37,156972,202496,3520718,3461655,25108,12.596,18798,9.43,559204,211487,347717,6.109,16.154,441245,148138,293107,4.279,12.747,117959,3.408,25.493,12598,12816,69001
2006,38,15643,19103,281002,276492,1931,10.18,1662,8.762,38487,12895,25592,4.664,13.92,29570,9413,20157,3.404,10.695,8917,3.225,21.389,1114,1127,5031
2006,39,186253,248624,4794593,4762757,24461,9.872,22755,9.184,656845,230898,425947,4.848,13.791,595060,192977,402083,4.052,12.494,61785,1.297,24.988,14848,15217,88914
2006,40,65221,81908,1277278,1245470,9328,11.498,7770,9.577,212749,80076,132673,6.429,17.082,149325,51037,98288,4.098,11.989,63424,5.092,23.979,5205,5354,26601
2006,41,81129,99252,1455061,1427305,12692,13.016,9209,9.444,225136,79607,145529,5.577,15.774,169915,50614,119301,3.546,11.905,55221,3.869,23.809,6317,6372,29541
2006,42,216708,279808,5178408,5123797,27622,9.928,24472,8.796,686270,243344,442926,4.749,13.394,577760,180741,397019,3.527,11.276,108510,2.118,22.552,16294,16743,91306
2006,44,23516,27252,439830,440007,3054,11.315,2530,9.374,60678,22340,38338,5.077,13.79,61063,16720,44343,3.8,13.878,-385,-0.087,27.581,1695,1734,8642
2006,45,75543,96993,1647055,1619915,11676,12.213,8896,9.305,259511,96756,162755,5.973,16.02,206042,64557,141485,3.985,12.719,53469,3.301,25.439,6042,6196,32470
2006,46,19293,22898,329558,323368,2515,11.067,2169,9.545,45210,14995,30215,4.637,13.981,32790,10112,22678,3.127,10.14,12420,3.841,20.28,1500,1528,6550
2006,47,94125,125614,2448274,2403253,14460,11.635,11790,9.487,375325,133929,241396,5.573,15.617,285281,90472,194809,3.765,11.871,90044,3.747,23.741,7681,7893,42815
2006,48,348328,465226,8685380,8467144,59138,12.886,46576,10.148,1531343,554068,977275,6.544,18.086,1098012,382351,715661,4.516,12.968,433331,5.118,25.936,30331,31113,186343
2006,49,48900,59227,1025539,993338,9706,16.903,6093,10.611,185416,66669,118747,6.712,18.666,121156,38553,82603,3.881,12.197,64260,6.469,24.394,4048,4140,23336
2006,50,17124,19934,261747,260495,1986,10.02,1759,8.875,30546,9662,20884,3.709,11.726,28011,8331,19680,3.198,10.753,2535,0.973,21.506,1242,1253,4973
2006,51,138326,179364,3189515,3130077,22292,12.641,16258,9.219,509521,180034,329487,5.752,16.278,391005,121965,269040,3.897,12.492,118516,3.786,24.984,10722,10894,59907
2006,53,130233,159821,2414023,2368538,21287,13.543,16005,10.183,398524,137327,261197,5.798,16.826,309813,94068,215745,3.972,13.08,88711,3.745,26.161,10834,10998,51187
2006,54,29417,37741,589233,579783,3745,9.946,3568,9.476,86188,29940,56248,5.164,14.866,67432,20222,47210,3.488,11.631,18756,3.235,23.261,2441,2481,11664
2006,55,104406,132338,2478154,2465826,13277,10.093,11703,8.896,310321,107894,202427,4.376,12.585,284437,80289,204148,3.256,11.535,25884,1.05,23.07,7966,8103,42503
2006,56,15420,17900,206400,200840,2289,12.987,1739,9.867,36380,12185,24195,6.067,18.114,25372,8198,17174,4.082,12.633,11008,5.481,25.266,1176,1188,5189
2007,01,74190,97820,1716145,1713216,10727,11.066,8961,9.244,256159,90024,166135,5.255,14.952,250138,77549,172589,4.527,14.6,6021,0.351,29.201,5748,5924,34712
2007,02,13833,17174,244755,243134,2032,11.9,1836,10.752,42808,14539,28269,5.98,17.607,39407,9105,30302,3.745,16.208,3401,1.399,32.416,1139,1155,4805
2007,04,97176,126138,2382798,2359751,18152,14.626,14088,11.352,445786,152844,292942,6.477,18.891,400608,129020,271588,5.468,16.977,45178,1.915,33.953,9017,9192,58060
2007,05,48030,61716,1026634,1034442,6630,10.805,5918,9.645,143744,50344,93400,4.867,13.896,158895,46791,112104,4.523,15.36,-15151,-1.465,27.792,3965,4009,22374
2007,06,633049,791037,13713986,13715068,100010,12.737,88260,11.241,2177440,749026,1428414,5.461,15.876,2179103,713429,1465674,5.202,15.888,-1663,-0.012,31.753,57475,58557,350664
2007,08,112064,137441,2057876,2040034,18885,13.897,15797,11.624,356927,131736,225191,6.458,17.496,321434,109871,211563,5.386,15.756,35493,1.74,31.513,10030,10140,52909
2007,09,68937,85119,1522825,1534939,8201,9.641,8097,9.518,208110,74180,133930,4.833,13.558,231385,63695,167690,4.15,15.075,-23275,-1.516,27.116,5064,5148,30872
2007,10,18132,22761,386066,387159,2631,11.578,2557,11.252,66117,28982,37135,7.486,17.077,68668,25445,43223,6.572,17.736,-2551,-0.659,34.155,1492,1497,10010
2007,11,15382,19404,436105,435583,2083,10.805,1832,9.503,70117,21370,48747,4.906,16.097,69437,19788,49649,4.543,15.941,680,0.156,31.882,983,990,6790
2007,12,372841,462075,7181830,7187153,67356,14.681,60816,13.255,1223243,484816,738427,6.746,17.02,1241534,457574,783960,6.367,17.274,-18291,-0.254,34.04,41100,41744,245514
2007,13,160398,206727,3626909,3618696,27452,13.45,22205,10.879,579126,227513,351613,6.287,16.004,561630,192344,369286,5.315,15.52,17496,0.483,31.04,14229,14607,87759
2007,15,24312,30704,515942,512931,3061,10.001,2865,9.361,76070,24796,51274,4.834,14.83,70120,25707,44413,5.012,13.67,5950,1.16,27.341,1720,1781,12089
2007,16,35076,41615,545640,543502,5842,14.319,4208,10.314,93591,35066,58525,6.452,17.22,89537,25946,63591,4.774,16.474,4054,0.746,32.948,2874,2899,16346
2007,17,229070,288702,5348739,5346714,30924,10.75,28835,10.024,773285,264349,508936,4.944,14.463,769118,241761,527357,4.522,14.385,4167,0.078,28.77,17894,18180,113745
2007,18,105737,139796,2632003,2644541,14103,10.122,13162,9.447,365138,122939,242199,4.649,13.807,390941,111474,279467,4.215,14.783,-25803,-0.976,27.614,8416,8598,55177
2007,19,58276,75296,1294475,1294405,6697,8.911,6406,8.524,160040,47634,112406,3.68,12.364,160233,45797,114436,3.538,12.379,-193,-0.015,24.728,4045,4109,22332
2007,20,55671,70546,1178141,1168383,7100,10.102,6575,9.355,171249,62043,109206,5.31,14.657,151844,47759,104085,4.088,12.996,19405,1.661,25.992,4172,4249,23915
2007,21,65872,86233,1540272,1543222,8652,10.068,8050,9.368,218834,77130,141704,4.998,14.18,224734,62908,161826,4.076,14.563,-5900,-0.382,28.361,5174,5253,32341
2007,22,74809,95875,1635252,1610685,11786,12.52,8311,8.829,284054,91476,192578,5.679,17.636,234207,69960,164247,4.343,14.541,49847,3.095,29.082,5134,5215,32340
2007,23,30709,37362,500434,503157,3955,10.633,3622,9.738,66631,23393,43238,4.649,13.243,72222,26697,45525,5.306,14.354,-5591,-1.111,26.485,2412,2428,13581
2007,24,101865,127361,2231380,2232267,14035,11.061,13083,10.311,327719,107428,220291,4.813,14.681,330242,101897,228345,4.565,14.794,-2523,-0.113,29.362,8193,8314,46240
2007,25,127908,159384,3065459,3060684,15461,9.702,15419,9.675,411851,127239,284612,4.157,13.456,401128,122105,279023,3.989,13.106,10723,0.35,26.212,9595,9761,53057
2007,26,164702,210752,3664514,3718520,20866,9.856,22762,10.752,484066,164508,319558,4.424,13.018,591145,186631,404514,5.019,15.897,-107079,-2.88,26.035,14672,15029,96090
2007,27,105913,133245,2509083,2488838,13942,10.466,13869,10.411,366556,113098,253458,4.544,14.728,326583,103281,223302,4.15,13.122,39973,1.606,26.244,8357,8451,45437
2007,28,44093,57072,938203,941357,6397,11.325,5227,9.253,130970,41272,89698,4.384,13.913,136930,40210,96720,4.271,14.546,-5960,-0.633,27.826,3453,3522,19446
2007,29,109205,140514,2432341,2437852,15189,10.83,14660,10.453,335428,114542,220886,4.698,13.759,345089,106923,238166,4.386,14.155,-9661,-0.396,27.518,9724,9922,50931
2007,30,28265,32917,353848,347930,4028,12.415,3085,9.508,57695,19376,38319,5.569,16.582,45588,14356,31232,4.126,13.103,12107,3.48,26.205,2054,2077,8681
2007,31,37861,47419,791263,787466,4486,9.492,4171,8.825,103415,32042,71373,4.069,13.133,96622,29152,67470,3.702,12.27,6793,0.863,24.54,2637,2652,13542
2007,32,43601,54747,1184366,1171656,8588,15.949,6787,12.604,221925,82633,139292,7.053,18.941,196377,64925,131452,5.541,16.761,25548,2.181,33.521,4533,4579,29633
2007,33,29419,35780,571363,571837,3600,10.068,3552,9.934,74486,22289,52197,3.898,13.026,75886,20988,54898,3.67,13.271,-1400,-0.245,26.052,2348,2364,11781
2007,34,183445,218164,3645355,3654441,24419,11.191,24502,11.229,530450,174596,355854,4.778,14.515,550313,182345,367968,4.99,15.059,-19863,-0.544,29.03,16142,16265,81738
2007,35,33967,42407,631438,630683,4850,11.547,4043,9.625,99816,34335,65481,5.444,15.827,97513,29600,67913,4.693,15.462,2303,0.365,30.923,2629,2672,14902
2007,36,387516,459696,7473986,7477544,51223,11.177,48422,10.566,1056323,353755,702568,4.731,14.127,1060300,368875,691425,4.933,14.18,-3977,-0.053,28.253,32520,32833,174047
2007,37,159554,206823,3554790,3539548,24631,12.033,20360,9.947,548922,193290,355632,5.461,15.508,518734,164007,354727,4.634,14.655,30188,0.853,29.311,12785,13031,75193
2007,38,15795,19385,290379,285613,1876,9.755,1567,8.149,44157,15115,29042,5.292,15.46,34414,8976,25438,3.143,12.049,9743,3.411,24.098,953,979,5239
2007,39,183767,247430,4748383,4772359,23195,9.353,24304,9.801,628549,221089,407460,4.633,13.171,676570,221097,455473,4.633,14.177,-48021,-1.006,26.341,14746,15076,93444
2007,40,65763,83139,1296728,1287092,9247,11.209,7967,9.657,210117,67695,142422,5.26,16.325,190393,59794,130599,4.646,14.792,19724,1.532,29.585,5210,5288,30896
2007,41,82668,101435,1474909,1467148,12089,12.049,9877,9.845,216339,71968,144371,4.905,14.746,200229,62471,137758,4.258,13.648,16110,1.098,27.295,6466,6568,31801
2007,42,216087,279785,5175772,5176918,26083,9.325,25957,9.28,682906,225273,457633,4.351,13.191,683590,225181,458409,4.35,13.205,-684,-0.013,26.383,15393,15722,90579
2007,44,23290,27197,442424,440943,2716,9.976,2771,10.178,61580,21828,39752,4.95,13.966,59129,20011,39118,4.538,13.41,2451,0.556,26.819,1859,1877,11042
2007,45,76489,98927,1658164,1652941,11564,11.807,9590,9.792,252020,87461,164559,5.291,15.247,242975,78338,164637,4.739,14.7,9045,0.547,29.399,6305,6453,39302
2007,46,19425,23188,330592,329428,2357,10.239,2020,8.775,44168,14533,29635,4.412,13.407,41919,12630,29289,3.834,12.725,2249,0.683,25.45,1308,1319,6467
2007,47,94918,127290,2466055,2454154,13890,10.986,12180,9.633,379590,123488,256102,5.032,15.467,357736,115773,241963,4.717,14.577,21854,0.89,29.154,7533,7685,47104
2007,48,353617,474922,8969976,8830876,59297,12.62,49177,10.466,1613959,560208,1053751,6.344,18.276,1334985,471049,863936,5.334,15.117,278974,3.159,30.234,30320,31045,204098
2007,49,51496,62155,1088832,1063267,9620,15.853,6676,11.001,197195,61605,135590,5.794,18.546,146198,52162,94036,4.906,13.75,50997,4.796,27.5,4320,4345,25021
2007,50,17168,19970,261035,261411,1922,9.637,1869,9.371,31985,10104,21881,3.865,12.236,32433,10358,22075,3.962,12.407,-448,-0.171,24.471,1149,1159,4642
2007,51,139560,181932,3182261,3185463,20803,11.517,18183,10.067,490596,168494,322102,5.289,15.401,497739,155209,342530,4.872,15.625,-7143,-0.224,30.802,11193,11353,68184
2007,53,132991,163324,2491452,2454670,20732,12.834,17159,10.622,398873,124113,274760,5.056,16.25,323655,103649,220006,4.223,13.185,75218,3.064,26.371,11052,11164,54473
2007,54,29190,37646,579520,584236,3478,9.229,3554,9.431,79478,26504,52974,4.537,13.604,88322,27903,60419,4.776,15.118,-8844,-1.514,27.208,2290,2330,14555
2007,55,104146,132468,2478784,2478781,12423,9.384,12243,9.249,306103,98360,207743,3.968,12.349,306154,94356,211798,3.807,12.351,-51,-0.002,24.698,7659,7791,41974
2007,56,15759,18353,214954,210752,2215,12.23,1732,9.563,37686,11569,26117,5.489,17.882,29258,9287,19971,4.407,13.883,8428,3.999,27.765,1144,1168,5079
2008,01,73364,97185,1707841,1711778,9016,9.249,9604,9.852,235639,77032,158607,4.5,13.766,243529,84415,159114,4.931,14.227,-7890,-0.461,27.531,6315,6506,37847
2008,02,13680,17018,247088,245797,1816,10.626,1960,11.469,35447,10159,25288,4.133,14.421,32954,8922,24032,3.63,13.407,2493,1.014,26.814,1198,1211,4980
2008,04,96271,125746,2308280,2346051,15813,12.559,16141,12.819,350084,130801,219283,5.575,14.922,425084,129750,295334,5.531,18.119,-75000,-3.197,29.845,10776,10980,69650
2008,05,47460,61248,1012372,1019346,5721,9.308,6149,10.005,127249,41966,85283,4.117,12.483,141206,41556,99650,4.077,13.853,-13957,-1.369,24.967,4134,4214,22529
2008,06,626741,785694,13539700,13599782,87360,11.085,92193,11.698,2001621,652802,1348819,4.8,14.718,2130191,710895,1419296,5.227,15.663,-128570,-0.945,29.436,61244,62409,380715
2008,08,111792,137542,2085800,2071725,16731,12.173,16528,12.026,335177,113347,221830,5.471,16.179,308367,110684,197683,5.343,14.885,26810,1.294,29.769,10685,10838,56932
2008,09,68139,84592,1532749,1528605,7488,8.826,7977,9.403,216734,68540,148194,4.484,14.179,209824,60178,149646,3.937,13.727,6910,0.452,27.453,5092,5161,26387
2008,10,17838,22474,384777,385127,2260,9.998,2521,11.153,57864,19350,38514,5.024,15.025,58203,16726,41477,4.343,15.113,-339,-0.088,30.049,1558,1571,7275
2008,11,15363,19457,443613,439651,1962,10.1,1899,9.776,60153,18708,41445,4.255,13.682,52358,15727,36631,3.577,11.909,7795,1.773,23.818,925,951,4844
2008,12,360830,450577,7032917,7113807,56176,12.313,67476,14.79,1063222,401105,662117,5.638,14.946,1227841,433976,793865,6.1,17.26,-164619,-2.314,29.892,46511,47051,236805
2008,13,158335,205301,3614276,3620942,23782,11.546,25133,12.202,548629,199207,349422,5.502,15.152,563323,196827,366496,5.436,15.557,-14694,-0.406,30.303,16603,16858,94123
2008,15,23987,30450,515908,516244,2652,8.676,2889,9.451,66721,21361,45360,4.138,12.924,67853,20688,47165,4.007,13.144,-1132,-0.219,25.849,1853,1906,10824
2008,16,34423,41169,534491,539949,4730,11.43,5155,12.457,73436,26756,46680,4.955,13.601,84959,25904,59055,4.797,15.735,-11523,-2.134,27.201,3577,3624,16536
2008,17,226794,287363,5390798,5368346,28379,9.855,29580,10.272,743997,222305,521692,4.141,13.859,701845,223579,478266,4.165,13.074,42152,0.785,26.148,18941,19232,106379
2008,18,104237,138242,2597355,2614471,12204,8.78,13704,9.86,325814,98190,227624,3.756,12.462,360822,116541,244281,4.458,13.801,-35008,-1.339,24.924,8731,8957,58455
2008,19,57621,74722,1306444,1299709,6020,8.028,6559,8.746,161080,44308,116772,3.409,12.394,147659,44349,103310,3.412,11.361,13421,1.033,22.722,4178,4263,22242
2008,20,55064,70018,1188321,1182819,6118,8.707,6619,9.42,155905,43146,112759,3.648,13.181,144999,43152,101847,3.648,12.259,10906,0.922,24.518,4239,4342,23651
2008,21,64834,85500,1535123,1537421,7456,8.683,8199,9.548,201209,62166,139043,4.044,13.087,206325,66490,139835,4.325,13.42,-5116,-0.333,26.175,5407,5510,35010
2008,22,74828,96238,1636016,1634076,9232,9.614,8817,9.181,237105,71835,165270,4.396,14.51,233271,67316,165955,4.12,14.275,3834,0.235,28.551,5700,5791,32880
2008,23,30094,36800,506042,503444,3420,9.225,3969,10.705,65577,20665,44912,4.105,13.026,60695,20234,40461,4.019,12.056,4882,0.97,24.112,2596,2644,11874
2008,24,100134,125761,2222386,2225248,12100,9.563,13640,10.78,305105,93248,211857,4.19,13.711,310077,104248,205829,4.685,13.934,-4972,-0.223,27.422,8654,8806,43472
2008,25,125873,157733,3064540,3063418,13766,8.684,15349,9.682,394685,118644,276041,3.873,12.884,393276,124029,269247,4.049,12.838,1409,0.046,25.676,9792,9945,54568
2008,26,160757,206712,3610211,3634629,18707,8.964,22662,10.859,496258,172744,323514,4.753,13.654,545622,183485,362137,5.048,15.012,-49364,-1.358,27.307,14835,15119,102907
2008,27,104075,131620,2480971,2496101,12313,9.3,13870,10.476,311725,100102,211623,4.01,12.488,343406,101643,241763,4.072,13.758,-31681,-1.269,24.977,8842,9052,51052
2008,28,43621,56887,942281,939465,5292,9.29,5450,9.567,131204,41695,89509,4.438,13.966,125753,40792,84961,4.342,13.386,5451,0.58,26.771,3728,3818,20129
2008,29,107557,139249,2439683,2435236,13354,9.55,14518,10.383,328026,109198,218828,4.484,13.47,318973,100522,218451,4.128,13.098,9053,0.372,26.196,9648,9782,46391
2008,30,28121,32846,358243,356041,3391,10.314,3453,10.503,51652,16014,35638,4.498,14.507,47158,15565,31593,4.372,13.245,4494,1.262,26.49,2345,2376,9469
2008,31,37643,47391,794594,793759,4193,8.847,4198,8.858,100944,28780,72164,3.626,12.717,100000,27020,72980,3.404,12.598,944,0.119,25.197,2720,2748,13585
2008,32,43246,54748,1152440,1168762,7601,13.891,7540,13.78,179858,70670,109188,6.047,15.389,212332,62367,149965,5.336,18.167,-32474,-2.778,30.778,5216,5324,33079
2008,33,28926,35358,588776,579643,3177,8.934,3585,10.081,92959,26794,66165,4.623,16.037,75826,22547,53279,3.89,13.082,17133,2.956,26.163,2400,2436,10778
2008,34,180132,215110,3592210,3615639,21371,9.867,24337,11.236,501307,167991,333316,4.646,13.865,548396,190453,357943,5.267,15.167,-47089,-1.302,27.73,16594,16784,92427
2008,35,33717,42211,637011,638015,4325,10.226,4488,10.612,96435,34812,61623,5.456,15.115,98444,33197,65247,5.203,15.43,-2009,-0.315,30.23,2847,2909,16388
2008,36,387826,460942,7536345,7501529,48193,10.471,46787,10.166,1023887,330323,693564,4.403,13.649,954316,307208,647108,4.095,12.722,69571,0.927,25.443,31871,32211,165466
2008,37,158626,206840,3542390,3545369,21401,10.35,21251,10.278,498308,167865,330443,4.735,14.055,505525,163019,342506,4.598,14.259,-7217,-0.204,28.11,14116,14375,79347
2008,38,15860,19464,296818,293457,1659,8.544,1567,8.07,39907,12176,27731,4.149,13.599,33119,9632,23487,3.282,11.286,6788,2.313,22.572,979,996,6430
2008,39,179510,242635,4700077,4723814,19750,8.062,24413,9.966,601272,197365,403907,4.178,12.729,648855,220970,427885,4.678,13.736,-47583,-1.007,25.457,14965,15323,106087
2008,40,65921,83820,1321991,1310228,8589,10.292,7856,9.414,199456,67503,131953,5.152,15.223,176450,55166,121284,4.21,13.467,23006,1.756,26.934,5256,5383,27919
2008,41,82116,101152,1475530,1476229,10605,10.472,10844,10.708,198772,61632,137140,4.175,13.465,200245,62259,137986,4.217,13.565,-1473,-0.1,26.93,7229,7342,33816
2008,42,214082,278951,5201721,5188259,23884,8.551,24622,8.815,660172,196649,463523,3.79,12.724,636799,198767,438032,3.831,12.274,23373,0.45,24.548,15484,15807,85587
2008,44,22783,26669,429758,435848,2384,8.854,2899,10.766,49666,15530,34136,3.563,11.395,62234,19171,43063,4.399,14.279,-12568,-2.884,22.791,1873,1893,8912
2008,45,75615,98492,1658597,1658104,9751,9.88,10158,10.292,232572,72668,159904,4.383,14.026,230179,71915,158264,4.337,13.882,2393,0.144,27.764,6804,6914,36994
2008,46,19330,23196,337603,333962,2127,9.176,2095,9.038,46225,13843,32382,4.145,13.841,38919,14379,24540,4.306,11.654,7306,2.188,23.307,1432,1446,6823
2008,47,94195,127775,2479452,2474604,12890,10.108,12381,9.709,355052,121741,233311,4.92,14.348,345410,93140,252270,3.764,13.958,9642,0.39,27.916,8185,8291,46253
2008,48,356018,479304,9132099,9045959,53642,11.246,48973,10.268,1499296,518377,980919,5.73,16.574,1330054,416930,913124,4.609,14.703,169242,1.871,29.407,31089,32034,204847
2008,49,51607,62591,1103173,1095830,8257,13.24,7800,12.508,184218,57825,126393,5.277,16.811,169648,58654,110994,5.352,15.481,14570,1.33,30.962,5318,5375,29125
2008,50,16888,19673,260637,260631,1649,8.325,1920,9.693,30384,10152,20232,3.895,11.658,30663,10386,20277,3.985,11.765,-279,-0.107,23.316,1217,1226,6130
2008,51,138279,180391,3160615,3171279,18034,9.957,19481,10.756,441352,136736,304616,4.312,13.917,464331,155187,309144,4.894,14.642,-22979,-0.725,27.834,12152,12360,61775
2008,53,132981,163775,2511830,2501138,18434,11.275,17882,10.937,356476,108190,248286,4.326,14.253,335549,106503,229046,4.258,13.416,20927,0.837,26.832,11904,12122,60308
2008,54,28488,37109,584566,582546,2951,7.897,3474,9.296,76931,21482,55449,3.688,13.206,73097,21263,51834,3.65,12.548,3834,0.658,25.096,2344,2360,11209
2008,55,102425,131104,2482072,2480299,10779,8.181,12074,9.164,286891,84832,202059,3.42,11.567,283070,86625,196445,3.493,11.413,3821,0.154,22.825,7893,8058,45304
2008,56,15832,18450,219096,216357,2021,10.988,1907,10.368,38426,11790,26636,5.449,17.76,33211,11511,21700,5.32,15.35,5215,2.41,30.7,1210,1224,5650
2009,01,71181,94833,1607423,1660093,7597,7.903,10180,10.59,170716,62752,107964,3.78,10.284,276610,71154,205456,4.286,16.662,-105894,-6.379,20.567,6767,6959,36665
2009,02,13567,16999,251235,249313,1784,10.472,1857,10.901,39257,12117,27140,4.86,15.746,35540,10917,24623,4.379,14.255,3717,1.491,28.51,1068,1104,4907
2009,04,91325,120559,2110423,2212372,13030,10.561,18668,15.131,276184,116867,159317,5.282,12.484,479811,165698,314113,7.49,21.688,-203627,-9.204,24.967,12144,12369,98479
2009,05,46629,60497,969067,991596,5377,8.817,6352,10.416,111017,43887,67130,4.426,11.196,156519,45440,111079,4.583,15.785,-45502,-4.589,22.392,4262,4356,25955
2009,06,610274,768177,12737266,13173349,78303,10.061,98521,12.659,1552663,581653,971010,4.415,11.786,2425601,706121,1719480,5.36,18.413,-872938,-6.627,23.573,64187,65629,397908
2009,08,108766,134438,1995721,2043218,14603,10.718,18226,13.377,262645,99827,162818,4.886,12.854,359654,106559,253095,5.215,17.602,-97009,-4.748,25.709,11479,11692,59039
2009,09,66261,82547,1457176,1498399,6297,7.524,8592,10.266,148430,48555,99875,3.24,9.906,229867,61410,168457,4.098,15.341,-81437,-5.435,19.812,5237,5319,32293
2009,10,17376,21998,367452,376859,2006,9.006,2560,11.493,44378,20588,23790,5.463,11.776,63508,18086,45422,4.799,16.852,-19130,-5.076,23.552,1524,1560,7908
2009,11,15310,19610,451124,448121,2033,10.39,1946,9.946,62888,20277,42611,4.525,14.034,57448,15646,41802,3.491,12.82,5440,1.214,25.64,999,1013,6206
2009,12,346429,435972,6556204,6803815,52333,11.778,69013,15.533,859504,370639,488865,5.448,12.633,1353151,404033,949118,5.938,19.888,-493647,-7.255,25.265,44896,45691,218978
2009,13,151898,198722,3397030,3511764,20496,10.128,27775,13.725,431416,182329,249087,5.192,12.285,661924,203131,458793,5.784,18.849,-230508,-6.564,24.57,18031,18453,109846
2009,15,23559,29993,485144,500958,2531,8.362,3080,10.176,49028,19017,30011,3.796,9.787,81203,21629,59574,4.318,16.21,-32175,-6.423,19.574,1934,1992,12886
2009,16,32540,39294,498597,516988,3692,9.161,5708,14.163,57384,23356,34028,4.518,11.1,93827,27514,66313,5.322,18.149,-36443,-7.049,22.199,3724,3768,17245
2009,17,221519,281311,5066048,5234921,24829,8.718,31802,11.167,529898,189730,340168,3.624,10.122,866287,239429,626858,4.574,16.548,-336389,-6.426,20.245,19709,20079,122918
2009,18,101306,134991,2433567,2516944,10370,7.58,13988,10.225,257259,82922,174337,3.295,10.221,424454,112221,312233,4.459,16.864,-167195,-6.643,20.442,8879,9142,56924
2009,19,56819,73985,1274864,1290574,5318,7.141,6283,8.437,138414,43061,95353,3.337,10.725,169719,39820,129899,3.085,13.151,-31305,-2.426,21.45,4145,4206,23789
2009,20,54154,69140,1155252,1172848,5446,7.815,6532,9.374,126042,39554,86488,3.372,10.747,161466,39927,121539,3.404,13.767,-35424,-3.02,21.493,4254,4381,22473
2009,21,63448,84232,1465779,1503321,6787,7.984,8345,9.816,165570,60361,105209,4.015,11.014,240219,62543,177676,4.16,15.979,-74649,-4.966,22.027,5364,5519,33354
2009,22,74546,96169,1628367,1637020,8447,8.761,8945,9.277,212249,70289,141960,4.294,12.966,228557,66701,161856,4.075,13.962,-16308,-0.996,25.931,5865,5960,38158
2009,23,28966,35694,487573,497090,2867,7.898,4081,11.242,50900,17389,33511,3.498,10.24,70058,19168,50890,3.856,14.094,-19158,-3.854,20.479,2553,2576,12005
2009,24,97128,123087,2122616,2176108,11107,8.91,14248,11.43,252026,93836,158190,4.312,11.582,357945,116037,241908,5.332,16.449,-105919,-4.867,23.163,8724,8864,48150
2009,25,122738,154499,2962203,3015746,12346,7.897,16037,10.257,317959,108417,209542,3.595,10.543,426799,116613,310186,3.867,14.152,-108840,-3.609,21.087,9685,9911,62921
2009,26,155292,200038,3370146,3495864,16349,8.025,23715,11.641,391938,136793,255145,3.913,11.211,643885,175072,468813,5.008,18.418,-251947,-7.207,22.423,14549,14810,91845
2009,27,101555,129187,2373596,2430343,11003,8.423,13887,10.631,266403,89940,176463,3.701,10.962,380174,86931,293243,3.577,15.643,-113771,-4.681,21.923,8529,8715,47929
2009,28,42672,56057,901498,924243,4661,8.236,5729,10.124,104523,43080,61443,4.661,11.309,150189,44249,105940,4.788,16.25,-45666,-4.941,22.618,3855,3981,27062
2009,29,105282,136919,2333484,2386514,12362,8.938,15150,10.953,261817,91188,170629,3.821,10.971,368181,111021,257160,4.652,15.428,-106364,-4.457,21.941,9966,10161,57855
2009,30,27137,31814,339987,349298,2821,8.709,3979,12.284,38395,11675,26720,3.342,10.992,57173,15120,42053,4.329,16.368,-18778,-5.376,21.984,2506,2546,9510
2009,31,37379,47158,779438,787588,3698,7.811,4067,8.591,87400,29877,57523,3.793,11.097,103584,30894,72690,3.923,13.152,-16184,-2.055,22.194,2583,2638,15642
2009,32,41673,53267,1041925,1098785,6613,12.221,8300,15.339,136982,56318,80664,5.125,12.467,251708,62492,189216,5.687,22.908,-114726,-10.441,24.933,5552,5702,37011
2009,33,28005,34401,564300,577800,2760,7.901,3825,10.949,56787,17167,39620,2.971,9.828,84118,20598,63520,3.565,14.558,-27331,-4.73,19.656,2405,2449,12341
2009,34,173672,208674,3416468,3508608,19072,8.984,26286,12.383,392068,139747,252321,3.983,11.174,577211,163398,413813,4.657,16.451,-185143,-5.277,22.349,17220,17486,90677
2009,35,32861,41413,611561,625049,3661,8.738,4626,11.042,73469,25683,47786,4.109,11.754,100548,26433,74115,4.229,16.086,-27079,-4.332,23.508,3011,3052,15452
2009,36,384372,457908,7286424,7419672,45443,9.873,50161,10.898,826183,292945,533238,3.948,11.135,1093328,318736,774592,4.296,14.736,-267145,-3.6,22.27,33329,33723,182113
2009,37,152488,201102,3318028,3434305,18062,8.839,24539,12.009,367137,143998,223139,4.193,10.69,600251,172195,428056,5.014,17.478,-233114,-6.788,21.381,15950,16266,87174
2009,38,15866,19459,292977,295058,1527,7.837,1579,8.104,33003,9234,23769,3.13,11.185,37067,10057,27010,3.408,12.563,-4064,-1.377,22.371,990,1003,5497
2009,39,174029,236746,4452959,4581715,17641,7.348,24326,10.132,481037,180249,300788,3.934,10.499,739003,202591,536412,4.422,16.129,-257966,-5.63,20.998,14855,15331,100298
2009,40,65682,83627,1282591,1303377,7518,8.961,8051,9.597,157547,53651,103896,4.116,12.088,198919,63852,135067,4.899,15.262,-41372,-3.174,24.175,5381,5483,37124
2009,41,78706,97780,1361934,1417526,8775,8.808,12471,12.518,152594,56788,95806,4.006,10.765,262900,68947,193953,4.864,18.546,-110306,-7.782,21.53,8117,8240,40276
2009,42,211063,275991,5019309,5113982,21448,7.717,25302,9.104,524668,178233,346435,3.485,10.259,715492,210526,504966,4.117,13.991,-190824,-3.731,20.519,15308,15717,107100
2009,44,21810,25607,409415,419268,2020,7.718,3151,12.039,42790,12743,30047,3.039,10.206,62491,17405,45086,4.151,14.905,-19701,-4.699,20.412,1966,1994,10127
2009,45,72829,95734,1542326,1598701,8657,8.903,11662,11.993,172182,70535,101647,4.412,10.77,285544,77925,207619,4.874,17.861,-113362,-7.091,21.54,7607,7888,43174
2009,46,19200,23085,331050,334397,1906,8.222,2102,9.067,37209,11575,25634,3.461,11.127,43958,11877,32081,3.552,13.145,-6749,-2.018,22.254,1387,1397,7693
2009,47,91530,125045,2316011,2401082,10696,8.45,13754,10.866,255775,92435,163340,3.85,10.652,426080,109292,316788,4.552,17.745,-170305,-7.093,21.305,8744,8989,55242
2009,48,354467,479789,8869335,9016551,49550,10.315,50717,10.558,1202402,452229,750173,5.016,13.335,1500585,420904,1079681,4.668,16.643,-298183,-3.307,26.671,32358,33269,209278
2009,49,49432,60605,1050205,1076934,6929,11.225,9175,14.864,141541,49043,92498,4.554,13.143,195837,57760,138077,5.363,18.185,-54296,-5.042,26.286,6118,6188,36537
2009,50,16392,19244,254907,258151,1514,7.766,2016,10.341,28078,10921,17157,4.23,10.877,35002,9601,25401,3.719,13.559,-6924,-2.682,21.753,1239,1256,6122
2009,51,134816,178052,3047179,3107091,16820,9.369,19790,11.023,371545,147291,224254,4.74,11.958,492521,141175,351346,4.544,15.852,-120976,-3.894,23.916,12569,12799,70577
2009,53,127839,159092,2375136,2446080,15287,9.452,20575,12.721,302222,96215,206007,3.933,12.355,443061,115284,327777,4.713,18.113,-140839,-5.758,24.711,13413,13632,66823
2009,54,27861,36703,575711,581384,2741,7.414,3279,8.869,67457,21809,45648,3.751,11.603,78975,20878,58097,3.591,13.584,-11518,-1.981,23.206,2196,2231,11453
2009,55,99896,128685,2350323,2419108,9623,7.397,12435,9.559,212540,67756,144784,2.801,8.786,349367,98616,250751,4.077,14.442,-136827,-5.656,17.572,7954,8111,52876
2009,56,15724,18369,211541,214934,1774,9.618,1924,10.432,28899,9087,19812,4.228,13.446,35692,9537,26155,4.437,16.606,-6793,-3.161,26.891,1300,1324,6190
2010,01,69395,93044,1569332,1587496,7403,7.885,9079,9.671,177840,60898,116942,3.836,11.203,213735,58483,155252,3.684,13.464,-35895,-2.261,22.405,5928,6065,30304
2010,02,13606,17126,253638,252655,1736,10.173,1613,9.452,33391,8666,24725,3.43,13.216,31418,7850,23568,3.107,12.435,1973,0.781,24.87,941,959,3833
2010,04,88472,117696,2051298,2081937,13051,10.955,15926,13.368,286991,113532,173459,5.453,13.785,348014,103963,244051,4.994,16.716,-61023,-2.931,27.57,9926,10207,51823
2010,05,46137,60164,964233,967363,5149,8.533,5504,9.121,115331,39128,76203,4.045,11.922,121105,34675,86430,3.584,12.519,-5774,-0.597,23.844,3623,3731,20683
2010,06,598949,756834,12338976,12541791,77283,10.134,88856,11.651,1534520,538609,995911,4.295,12.235,1937985,604628,1333357,4.821,15.452,-403465,-3.217,24.471,55982,57330,310372
2010,08,106781,132501,1953702,1975829,14799,11.087,16767,12.561,265235,97532,167703,4.936,13.424,308743,94476,214267,4.782,15.626,-43508,-2.202,26.848,10211,10402,48528
2010,09,65084,81353,1427553,1442574,6528,7.966,7721,9.422,153909,50913,102996,3.529,10.669,183035,49533,133502,3.434,12.688,-29126,-2.019,21.338,4658,4760,24772
2010,10,17159,21664,360128,363950,1960,8.976,2303,10.547,41383,12306,29077,3.381,11.371,48770,14921,33849,4.1,13.4,-7387,-2.03,22.741,1328,1352,5990
2010,11,15411,19878,461729,461833,2030,10.281,1763,8.929,55999,18998,37001,4.114,12.125,55737,13734,42003,2.974,12.069,262,0.057,24.137,954,965,5900
2010,12,343501,432456,6456573,6509649,54129,12.465,57729,13.294,951586,350447,601139,5.384,14.618,1055272,357419,697853,5.491,16.211,-103686,-1.593,29.236,36867,37539,177967
2010,13,148674,194951,3310724,3352091,19730,10.022,23554,11.965,400648,142635,258013,4.255,11.952,483177,154616,328561,4.613,14.414,-82529,-2.462,23.904,14713,15033,76422
2010,15,23117,29612,477308,481171,2372,7.959,2757,9.25,56176,20883,35293,4.34,11.675,63961,17572,46389,3.652,13.293,-7785,-1.618,23.35,1727,1774,9034
2010,16,31813,38561,488658,493616,3944,10.131,4680,12.022,61713,20626,41087,4.179,12.502,71617,19754,51863,4.002,14.509,-9904,-2.006,25.004,3015,3080,12395
2010,17,218656,278531,4943474,5014705,25496,9.108,28324,10.118,542452,193528,348924,3.859,10.817,686246,193959,492287,3.868,13.685,-143794,-2.867,21.634,17069,17391,98987
2010,18,99580,133294,2394073,2413920,10231,7.626,11947,8.906,271136,86203,184933,3.571,11.232,311002,85539,225463,3.544,12.884,-39866,-1.652,22.464,7499,7689,44402
2010,19,56391,73762,1246528,1260726,5393,7.3,5618,7.605,121307,36154,85153,2.868,9.622,148778,39589,109189,3.14,11.801,-27471,-2.179,19.244,3479,3554,23814
2010,20,53432,68502,1122935,1139757,5358,7.785,6012,8.735,119714,38853,80861,3.409,10.503,153310,42307,111003,3.712,13.451,-33596,-2.948,21.007,3806,3886,20347
2010,21,62503,83495,1437790,1452061,6664,7.946,7406,8.831,163900,54956,108944,3.785,11.287,191740,49906,141834,3.437,13.205,-27840,-1.917,22.575,4739,4884,28007
2010,22,74065,96062,1591767,1610682,8138,8.466,8273,8.606,186202,66811,119391,4.148,11.56,224878,55842,169036,3.467,13.962,-38676,-2.401,23.121,5336,5483,33212
2010,23,28752,35551,479606,483903,3166,8.886,3321,9.321,50331,17911,32420,3.701,10.401,59027,16752,42275,3.462,12.198,-8696,-1.797,20.802,2020,2055,8785
2010,24,95785,121643,2072594,2097250,11226,9.173,12690,10.37,244079,80927,163152,3.859,11.638,293067,84382,208685,4.023,13.974,-48988,-2.336,23.276,7515,7800,42777
2010,25,121201,153365,2931034,2946980,13273,8.622,14422,9.369,323099,103000,220099,3.495,10.964,353320,95667,257653,3.246,11.989,-30221,-1.025,21.927,8594,8804,46619
2010,26,151613,195888,3283041,3327452,16001,8.085,20038,10.125,390959,120772,270187,3.63,11.75,480527,146632,333895,4.407,14.441,-89568,-2.692,23.499,12449,12749,75553
2010,27,100376,128187,2348732,2361032,11037,8.577,12029,9.348,263372,85169,178203,3.607,11.155,287297,85989,201308,3.642,12.168,-23925,-1.013,22.31,7190,7329,40706
2010,28,42113,55529,880881,891043,4485,8.038,5016,8.99,95578,32034,63544,3.595,10.727,115818,31982,83836,3.589,12.998,-20240,-2.271,21.453,3263,3350,17777
2010,29,103681,135338,2274175,2303538,12971,9.554,13838,10.192,254624,90662,163962,3.936,11.054,313501,84172,229329,3.654,13.61,-58877,-2.556,22.107,8663,8902,42736
2010,30,26774,31469,336895,338438,2927,9.25,3276,10.353,42987,16305,26682,4.818,12.702,46181,14358,31823,4.242,13.645,-3194,-0.944,25.403,2062,2089,9341
2010,31,37347,47251,770106,774859,3720,7.88,3639,7.708,79034,23630,55404,3.05,10.2,88359,20844,67515,2.69,11.403,-9325,-1.203,20.4,2222,2283,11731
2010,32,40637,52270,995962,1020165,6464,12.248,7475,14.164,138056,59325,78731,5.815,13.533,185822,53271,132551,5.222,18.215,-47766,-4.682,27.065,4839,4940,31543
2010,33,27719,34097,561160,562706,2913,8.504,3224,9.412,66761,19727,47034,3.506,11.864,70045,18605,51440,3.306,12.448,-3284,-0.584,23.729,1996,2044,10442
2010,34,170362,205016,3357463,3388671,19416,9.385,23139,11.185,394391,137838,256553,4.068,11.639,456982,152017,304965,4.486,13.486,-62591,-1.847,23.277,14520,14711,78379
2010,35,31998,40547,595818,603712,3490,8.516,4357,10.632,68106,21741,46365,3.601,11.281,83946,23082,60864,3.823,13.905,-15840,-2.624,22.562,2798,2846,13250
2010,36,385289,459204,7217718,7254181,47607,10.381,46427,10.123,853098,303091,550007,4.178,11.76,925928,290039,635889,3.998,12.764,-72830,-1.004,23.52,30753,31198,155375
2010,37,150098,198880,3218409,3265064,19253,9.626,21503,10.751,383687,145783,237904,4.465,11.751,474939,139965,334974,4.287,14.546,-91252,-2.795,23.503,13088,13446,68850
2010,38,16059,19714,295233,294056,1620,8.272,1361,6.949,34008,9899,24109,3.366,11.565,31599,8216,23383,2.794,10.746,2409,0.819,21.492,816,827,3425
2010,39,170319,232840,4341416,4397314,17342,7.386,21268,9.058,459134,142954,316180,3.251,10.441,570290,150158,420132,3.415,12.969,-111156,-2.528,20.882,12384,12842,75727
2010,40,64956,83003,1235946,1259096,6994,8.395,7617,9.142,138650,53646,85004,4.261,11.012,184555,51939,132616,4.125,14.658,-45905,-3.646,22.024,4935,5004,25977
2010,41,77473,96840,1323134,1337489,9557,9.822,10487,10.777,152659,53289,99370,3.984,11.414,180758,52591,128167,3.932,13.515,-28099,-2.101,22.828,6515,6653,27891
2010,42,208143,273437,4954505,4987891,21015,7.649,23622,8.598,539763,178619,361144,3.581,10.821,606712,169164,437548,3.391,12.164,-66949,-1.342,21.643,14145,14518,77342
2010,44,21418,25315,395210,403130,2279,8.951,2571,10.098,42626,16667,25959,4.134,10.574,58375,16473,41902,4.086,14.48,-15749,-3.907,21.148,1619,1628,7465
2010,45,71288,94277,1500422,1524842,8486,8.932,9949,10.472,174989,66752,108237,4.378,11.476,223151,61509,161642,4.034,14.634,-48162,-3.158,22.952,6344,6524,33362
2010,46,19204,23196,329125,330092,1951,8.431,1838,7.943,36690,13131,23559,3.978,11.115,38754,10466,28288,3.171,11.74,-2064,-0.625,22.23,1187,1196,6009
2010,47,89805,123312,2262476,2289301,10373,8.354,12097,9.742,266258,86984,179274,3.8,11.631,319074,94310,224764,4.12,13.938,-52816,-2.307,23.261,7556,7784,46613
2010,48,354121,481208,8747165,8810726,48695,10.134,47330,9.85,1191711,462713,728998,5.252,13.526,1313265,374359,938906,4.249,14.905,-121554,-1.38,27.051,29651,30441,182924
2010,49,48739,59903,1008896,1029286,7250,12.031,7967,13.221,128568,50221,78347,4.879,12.491,168435,49704,118731,4.829,16.364,-39867,-3.873,24.982,5040,5175,28598
2010,50,16228,19107,253961,254541,1505,7.846,1653,8.618,26487,9171,17316,3.603,10.406,27689,6978,20711,2.741,10.878,-1202,-0.472,20.812,1027,1035,4158
2010,51,133109,176369,2996260,3023440,16284,9.189,17989,10.151,366991,124618,242373,4.122,12.138,420906,136793,284113,4.524,13.921,-53915,-1.783,24.276,10683,11031,62303
2010,53,126147,157513,2288851,2318662,15983,10.096,17570,11.099,277529,104619,172910,4.512,11.969,336724,93679,243045,4.04,14.522,-59195,-2.553,23.939,11177,11413,49763
2010,54,27218,36175,564121,570041,2484,6.816,3019,8.284,63719,20714,43005,3.634,11.178,75305,18654,56651,3.272,13.21,-11586,-2.032,22.356,1910,1978,9630
2010,55,98313,127276,2319716,2334888,9442,7.377,10860,8.485,232582,76245,156337,3.265,9.961,263051,68885,194166,2.95,11.266,-30469,-1.305,19.922,6761,6957,33637
2010,56,15312,17981,201405,206021,1528,8.407,1917,10.547,23597,7860,15737,3.815,11.454,32682,7550,25132,3.665,15.863,-9085,-4.41,22.907,1222,1240,4782
2011,01,68325,91886,1588562,1578695,7462,8.07,8612,9.314,209669,54014,155655,3.421,13.281,187302,55986,131316,3.546,11.864,22367,1.417,23.729,5394,5683,27253
2011,02,13618,17312,254205,253866,1767,10.263,1579,9.171,31799,10001,21798,3.939,12.526,30873,7554,23319,2.976,12.161,926,0.365,24.322,950,973,3286
2011,04,87577,117016,2105849,2079481,13493,11.498,14171,12.075,320645,105571,215074,5.077,15.419,268942,96841,172101,4.657,12.933,51703,2.486,25.866,8938,9194,48595
2011,05,45716,59864,977106,970600,5215,8.691,5497,9.161,122718,39244,83474,4.043,12.644,110235,31295,78940,3.224,11.357,12483,1.286,22.715,3580,3740,17931
2011,06,599741,759360,12549440,12445502,82216,10.845,79695,10.512,1735388,548092,1187296,4.404,13.944,1530920,529585,1001335,4.255,12.301,204468,1.643,24.602,50716,52059,271153
2011,08,106467,132525,1980213,1967865,15170,11.448,15143,11.428,280553,89503,191050,4.548,14.257,255606,83494,172112,4.243,12.989,24947,1.268,25.978,9337,9488,43789
2011,09,64227,80529,1433243,1430387,6491,8.019,7324,9.048,160701,48362,112339,3.381,11.235,154464,48473,105991,3.389,10.799,6237,0.436,21.598,4500,4573,22938
2011,10,17036,21543,359726,360313,2008,9.293,2138,9.894,43269,12588,30681,3.494,12.009,44409,13767,30642,3.821,12.325,-1140,-0.316,24.017,1267,1291,5563
2011,11,15578,20058,473202,467833,1940,9.715,1764,8.833,60799,17105,43694,3.656,12.996,49765,13759,36006,2.941,10.637,11034,2.359,21.275,868,876,5354
2011,12,346112,435870,6577021,6523437,57202,13.175,53806,12.393,1045879,376244,669635,5.768,16.033,937617,356526,581091,5.465,14.373,108262,1.66,28.746,34784,35538,171740
2011,13,147479,194116,3321470,3316141,20578,10.578,21416,11.009,446736,149787,296949,4.517,13.472,434767,152899,281868,4.611,13.111,11969,0.361,26.221,13537,13939,73495
2011,15,22797,29354,483216,480067,2377,8.062,2635,8.937,57350,19110,38240,3.981,11.946,51299,17258,34041,3.595,10.686,6051,1.26,21.372,1633,1677,8934
2011,16,30991,37775,481711,485039,3788,9.926,4562,11.954,60241,19676,40565,4.057,12.42,66500,21335,45165,4.399,13.71,-6259,-1.29,24.84,2848,2938,13439
2011,17,218253,278611,5023407,4984673,26919,9.663,26856,9.64,618349,184334,434015,3.698,12.405,540033,171516,368517,3.441,10.834,78316,1.571,21.668,16577,17078,85566
2011,18,98473,132613,2432090,2412756,10877,8.181,11552,8.689,290166,78785,211381,3.265,12.026,250528,72171,178357,2.991,10.383,39638,1.643,20.767,7260,7585,38972
2011,19,55942,73519,1255917,1250706,5473,7.432,5714,7.759,133734,37793,95941,3.022,10.693,123104,35684,87420,2.853,9.843,10630,0.85,19.686,3593,3667,18430
2011,20,52620,68074,1121995,1122593,5637,8.255,6062,8.877,131672,44597,87075,3.973,11.729,132729,38618,94111,3.44,11.823,-1057,-0.094,23.459,3925,3994,19781
2011,21,61677,82979,1444822,1441581,6722,8.076,7226,8.682,172049,49954,122095,3.465,11.935,164344,50670,113674,3.515,11.4,7705,0.534,22.801,4775,4930,28360
2011,22,73721,96309,1608683,1600140,8412,8.746,8158,8.482,208253,67420,140833,4.213,13.015,191005,50602,140403,3.162,11.937,17248,1.078,23.874,5309,5464,27215
2011,23,28336,35174,478382,478945,3095,8.752,3475,9.826,52993,16900,36093,3.529,11.065,54146,17931,36215,3.744,11.305,-1153,-0.241,22.129,2058,2151,10344
2011,24,94963,121341,2106758,2091060,11456,9.429,11760,9.68,272422,85011,187411,4.065,13.028,240896,75788,165108,3.624,11.52,31526,1.508,23.041,7351,7467,37276
2011,25,121072,153643,2968109,2950348,13385,8.719,13117,8.545,331967,89340,242627,3.028,11.252,296598,83141,213457,2.818,10.053,35369,1.199,20.106,7824,7956,40952
2011,26,150837,195888,3376276,3327314,17769,9.071,17756,9.065,472987,126750,346237,3.809,14.215,374410,123111,251299,3.7,11.253,98577,2.963,22.505,11146,11442,62605
2011,27,99993,128233,2389920,2369416,11476,8.951,11430,8.915,274152,76064,198088,3.21,11.57,233219,68427,164792,2.888,9.843,40933,1.728,19.686,7131,7331,38056
2011,28,41720,55385,893074,887043,4605,8.304,4748,8.562,107740,33671,74069,3.796,12.146,95820,28203,67617,3.179,10.802,11920,1.344,21.604,3109,3243,16545
2011,29,101435,133696,2277044,2276147,12271,9.14,13379,9.966,252149,75893,176256,3.334,11.078,249570,72702,176868,3.194,10.965,2579,0.113,21.929,8925,9120,40217
2011,30,26450,31187,334840,335900,3011,9.612,3288,10.496,40783,12205,28578,3.634,12.141,42695,13739,28956,4.09,12.711,-1912,-0.569,24.283,2027,2076,8192
2011,31,37111,47183,759106,757414,3863,8.182,3927,8.317,84874,24126,60748,3.185,11.206,80737,24216,56521,3.197,10.66,4137,0.546,21.319,2421,2470,11948
2011,32,40586,52375,996528,998090,6485,12.377,6526,12.455,134131,44331,89800,4.442,13.439,137088,46993,90095,4.708,13.735,-2957,-0.296,26.878,4321,4413,29605
2011,33,27344,33785,554815,558599,2793,8.229,3105,9.148,57865,16972,40893,3.038,10.359,64780,17864,46916,3.198,11.597,-6915,-1.238,20.718,1983,2011,9350
2011,34,169155,204018,3373160,3365748,20136,9.845,21142,10.337,419940,123727,296213,3.676,12.477,404549,132780,271769,3.945,12.02,15391,0.457,24.039,13648,13829,65132
2011,35,31667,40387,593814,594418,3765,9.305,3911,9.666,70278,21563,48715,3.628,11.823,71256,19154,52102,3.222,11.988,-978,-0.165,23.646,2550,2622,11542
2011,36,387556,462465,7336375,7278138,49255,10.688,45985,9.979,940019,299125,640894,4.11,12.916,822429,273552,548877,3.759,11.3,117590,1.616,22.6,30392,30776,143730
2011,37,148611,197600,3268993,3242818,18835,9.501,20123,10.151,424226,133116,291110,4.105,13.082,371598,118085,253513,3.641,11.459,52628,1.623,22.918,12677,13063,64794
2011,38,16334,20160,309755,303470,1924,9.651,1476,7.404,42816,12700,30116,4.185,14.109,30543,7610,22933,2.508,10.065,12273,4.044,20.129,920,936,4445
2011,39,168740,231155,4420355,4384508,18038,7.775,19717,8.499,539088,139051,400037,3.171,12.295,467736,144408,323328,3.294,10.668,71352,1.627,21.336,11728,12257,71899
2011,40,64634,83060,1262350,1249296,7414,8.93,7346,8.848,164179,47493,116686,3.802,13.142,138154,41743,96411,3.341,11.059,26025,2.083,22.117,4895,5053,23170
2011,41,77062,96559,1339386,1331761,9460,9.784,9717,10.05,167039,46439,120600,3.487,12.543,151894,49739,102155,3.735,11.406,15145,1.137,22.811,6135,6333,26405
2011,42,207408,273780,5055105,5008072,22067,8.065,21715,7.937,612836,183152,429684,3.657,12.237,518190,153819,364371,3.071,10.347,94646,1.89,20.694,13160,13506,68219
2011,44,21187,25175,403877,399693,2268,8.983,2412,9.554,49296,15577,33719,3.897,12.333,40557,14041,26516,3.513,10.147,8739,2.186,20.294,1480,1503,6488
2011,45,70167,93365,1526723,1513519,8393,8.946,9293,9.906,205342,63811,141531,4.216,13.567,178456,54663,123793,3.612,11.791,26886,1.776,23.582,6006,6186,31813
2011,46,19089,23181,325630,327042,1876,8.091,1886,8.134,34398,9791,24607,2.994,10.518,37274,9818,27456,3.002,11.397,-2876,-0.879,21.036,1215,1248,6258
2011,47,88767,122195,2297259,2280292,10500,8.553,11638,9.48,289826,78665,211161,3.45,12.71,255445,84777,170668,3.718,11.202,34381,1.508,22.405,7291,7527,41670
2011,48,356069,485467,8942652,8851466,50587,10.466,46315,9.582,1304342,426035,878307,4.813,14.736,1122155,330648,791507,3.736,12.678,182187,2.058,25.355,29724,30581,177404
2011,49,48795,60111,1019949,1014904,7278,12.129,7062,11.769,137855,46096,91759,4.542,13.583,127713,40453,87260,3.986,12.584,10142,0.999,25.168,4399,4503,24216
2011,50,16055,18900,254378,254082,1553,8.173,1758,9.251,27144,7068,20076,2.782,10.683,26462,8383,18079,3.299,10.415,682,0.268,20.829,1107,1128,4509
2011,51,132230,176314,3028155,3013798,17279,9.799,17326,9.825,397060,126105,270955,4.184,13.175,368187,109674,258513,3.639,12.217,28873,0.958,24.433,10595,10904,52259
2011,53,124464,156016,2286930,2274320,15929,10.162,17401,11.101,306218,90909,215309,3.997,13.464,280305,84172,196133,3.701,12.325,25913,1.139,24.65,11022,11362,48498
2011,54,26737,35885,571195,567871,2710,7.522,2996,8.316,68534,17560,50974,3.092,12.069,61578,16937,44641,2.983,10.844,6956,1.225,21.687,1952,2015,11121
2011,55,97039,126196,2354247,2337113,9424,7.436,10499,8.284,254145,63235,190910,2.706,10.874,219510,60217,159293,2.577,9.392,34635,1.482,18.785,6576,6806,33641
2011,56,15407,18166,204925,203331,1872,10.357,1691,9.355,29929,8563,21366,4.211,14.719,26523,8022,18501,3.945,13.044,3406,1.675,26.088,1077,1087,4415
2012,01,67979,91744,1583030,1585862,7742,8.434,7853,8.555,202749,58150,144599,3.667,12.785,209199,59322,149877,3.741,13.192,-6450,-0.407,25.57,4920,5053,30053
2012,02,13720,17416,257324,256133,1733,9.98,1632,9.398,37016,10399,26617,4.06,14.452,34508,7857,26651,3.068,13.473,2508,0.979,26.945,879,891,3388
2012,04,87772,117126,2123684,2115209,12878,11.001,12756,10.897,316625,100884,215741,4.769,14.969,301275,108296,192979,5.12,14.243,15350,0.726,28.487,7712,7937,41986
2012,05,45649,59749,972355,974386,5003,8.367,5101,8.53,116308,29814,86494,3.06,11.937,120389,36362,84027,3.732,12.355,-4081,-0.419,23.873,3252,3330,18288
2012,06,608213,767382,12812252,12677998,84686,11.095,76437,10.015,1852188,543716,1308472,4.289,14.609,1584261,532651,1051610,4.201,12.496,267927,2.113,24.992,46590,47738,264820
2012,08,107468,133327,2030265,2005239,15026,11.306,14188,10.675,293070,93539,199531,4.665,14.615,243910,87097,156813,4.343,12.164,49160,2.452,24.327,8341,8531,41687
2012,09,64469,80789,1458053,1446035,6968,8.64,6691,8.296,180352,48970,131382,3.387,12.472,156035,47729,108306,3.301,10.791,24317,1.682,21.581,3970,4040,21206
2012,10,16917,21544,362468,360974,2113,9.807,2116,9.821,49178,16393,32785,4.541,13.624,46535,17901,28634,4.959,12.892,2643,0.732,25.783,1187,1225,5909
2012,11,15708,20033,481538,476758,1816,9.061,1832,9.141,66120,17765,48355,3.726,13.869,56323,18484,37839,3.877,11.814,9797,2.055,23.628,840,855,10207
2012,12,354864,445380,6813752,6698821,57655,13.086,48058,10.908,1108463,402700,705763,6.012,16.547,878735,343836,534899,5.133,13.118,229728,3.429,26.236,30065,30821,206539
2012,13,148029,194637,3362807,3342449,20986,10.797,20446,10.519,472588,160879,311709,4.813,14.139,429879,162161,267718,4.852,12.861,42709,1.278,25.722,12150,12385,67331
2012,15,22674,29119,489076,485566,2280,7.799,2511,8.589,58362,16827,41535,3.465,12.019,50891,16208,34683,3.338,10.481,7471,1.539,20.962,1425,1455,7578
2012,16,31079,37831,494171,487931,3953,10.458,3886,10.281,70750,23149,47601,4.744,14.5,57997,21920,36077,4.492,11.886,12753,2.614,23.773,2366,2404,10395
2012,17,219266,279010,5092096,5057150,26533,9.517,26083,9.356,660987,193505,467482,3.826,13.07,590357,203844,386513,4.031,11.674,70630,1.397,23.347,15253,15790,84837
2012,18,98557,132677,2505216,2468628,11161,8.415,11074,8.349,336259,96291,239968,3.901,13.621,263064,81503,181561,3.302,10.656,73195,2.965,21.313,6556,6781,39947
2012,19,56156,73740,1280807,1269203,5676,7.71,5435,7.383,147413,35856,111557,2.825,11.615,124165,38761,85404,3.054,9.783,23248,1.832,19.566,3287,3360,18588
2012,20,52561,67985,1142776,1132208,5660,8.321,5730,8.424,144843,43519,101324,3.844,12.793,123350,38115,85235,3.366,10.895,21493,1.898,21.789,3398,3539,18661
2012,21,61607,83033,1477591,1461385,6940,8.362,6858,8.263,196447,56969,139478,3.898,13.443,163889,50065,113824,3.426,11.215,32558,2.228,22.429,4189,4332,22589
2012,22,74018,96789,1633136,1619435,8567,8.874,8067,8.356,222332,64576,157756,3.988,13.729,195624,56456,139168,3.486,12.08,26708,1.649,24.16,4873,5040,29588
2012,23,28232,35094,483996,481154,3166,9.012,3237,9.214,56492,16911,39581,3.515,11.741,51087,15909,35178,3.306,10.618,5405,1.123,21.235,1919,1994,9042
2012,24,95803,122125,2143726,2126280,11457,9.412,10652,8.751,282019,81321,200698,3.825,13.263,246771,75984,170787,3.574,11.606,35248,1.658,23.212,6155,6310,33676
2012,25,122510,154816,3031101,3000251,13987,9.07,12789,8.293,357449,89836,267613,2.994,11.914,295431,96400,199031,3.213,9.847,62018,2.067,19.694,7334,7554,44835
2012,26,151545,195810,3459754,3416750,17062,8.713,17097,8.731,470895,119328,351567,3.492,13.782,387605,136960,250645,4.008,11.344,83290,2.438,22.689,10074,10385,72672
2012,27,100431,128516,2456318,2422659,11214,8.737,10892,8.486,310011,74908,235103,3.092,12.796,240760,77057,163703,3.181,9.938,69251,2.858,19.876,6392,6589,42575
2012,28,41364,55046,897612,896438,4335,7.853,4644,8.413,100984,29188,71796,3.256,11.265,98304,26263,72041,2.93,10.966,2680,0.299,21.932,2927,2991,14588
2012,29,101308,133428,2309729,2293671,12610,9.443,12842,9.616,286684,83458,203226,3.639,12.499,255463,78469,176994,3.421,11.138,31221,1.361,22.275,8089,8454,38178
2012,30,26753,31547,341760,338418,3244,10.343,2876,9.17,44896,13943,30953,4.12,13.266,38126,11895,26231,3.515,11.266,6770,2.0,22.532,1721,1749,6595
2012,31,37425,47488,774859,766950,3896,8.231,3582,7.568,94092,26210,67882,3.417,12.268,78699,21700,56999,2.829,10.261,15393,2.007,20.523,2166,2210,11544
2012,32,40919,52684,1014286,1005375,6450,12.278,6148,11.703,143109,47915,95194,4.766,14.234,125202,48188,77014,4.793,12.453,17907,1.781,24.907,3871,4024,27660
2012,33,27442,33961,547713,550796,3046,8.993,2865,8.459,62053,18835,43218,3.42,11.266,67733,27252,40481,4.948,12.297,-5680,-1.031,22.532,1728,1777,10297
2012,34,170953,205760,3431360,3404873,21435,10.463,19653,9.593,458088,136159,321929,3.999,13.454,405478,134232,271246,3.942,11.909,52610,1.545,23.818,12410,12623,64927
2012,35,31641,40346,591727,592893,3707,9.186,3728,9.238,74610,23805,50805,4.015,12.584,76946,24306,52640,4.1,12.978,-2336,-0.394,25.168,2282,2388,10697
2012,36,393608,468777,7500857,7417325,49966,10.732,43582,9.361,969724,287380,682344,3.874,13.074,801718,259879,541839,3.504,10.809,168006,2.265,21.617,28991,29452,140966
2012,37,149221,198505,3327973,3295474,19292,9.742,18346,9.264,440800,127750,313050,3.877,13.376,375688,122996,252692,3.732,11.4,65112,1.976,22.8,11049,11308,61804
2012,38,17014,20963,332931,321469,2284,11.109,1477,7.184,55472,16308,39164,5.073,17.256,32041,9740,22301,3.03,9.967,23431,7.289,19.934,962,978,5592
2012,39,168785,231043,4520115,4469802,18748,8.114,18801,8.137,588109,153238,434871,3.428,13.157,485554,152682,332872,3.416,10.863,102555,2.294,21.726,10810,11231,72695
2012,40,65155,83722,1294082,1278629,7764,9.312,7081,8.492,181302,57733,123569,4.515,14.179,150488,47647,102841,3.726,11.769,30814,2.41,23.539,4429,4557,23922
2012,41,77586,96848,1365669,1352250,9556,9.883,9244,9.56,177006,52576,124430,3.888,13.09,150267,45983,104284,3.4,11.112,26739,1.977,22.225,5384,5474,23887
2012,42,208323,274314,5141953,5099088,22120,8.072,21555,7.866,627920,170835,457085,3.35,12.314,540800,168009,372791,3.295,10.606,87120,1.709,21.212,12528,12935,76348
2012,44,21229,25197,404054,404126,2319,9.207,2297,9.12,46035,13148,32887,3.253,11.391,46463,13229,33234,3.273,11.497,-428,-0.106,22.783,1382,1400,6630
2012,45,70237,93322,1554185,1537865,8248,8.84,8208,8.797,203776,57051,146725,3.71,13.251,171402,50565,120837,3.288,11.145,32374,2.105,22.291,4956,5092,24432
2012,46,19219,23410,332069,328865,2059,8.84,1824,7.831,41741,12616,29125,3.836,12.692,35020,11900,23120,3.619,10.649,6721,2.044,21.297,1183,1202,5190
2012,47,88443,121878,2352220,2325910,10519,8.62,10817,8.864,307055,83731,223324,3.6,13.201,254471,80865,173606,3.477,10.941,52584,2.261,21.881,6551,6722,38953
2012,48,362834,493109,9290800,9122458,52860,10.805,45089,9.216,1444020,457212,986808,5.012,15.829,1103581,371361,732220,4.071,12.097,340439,3.732,24.195,27143,28165,177023
2012,49,49758,61224,1055313,1037696,7556,12.455,6438,10.612,154602,45993,108609,4.432,14.899,119032,36092,82940,3.478,11.471,35570,3.428,22.942,4038,4131,22297
2012,50,16068,18958,265541,259874,1663,8.786,1601,8.459,36774,9284,27490,3.573,14.151,25813,7990,17823,3.075,9.933,10961,4.218,19.866,1024,1050,4930
2012,51,132846,176663,3085792,3057761,16527,9.365,16145,9.149,437010,120110,316900,3.928,14.292,380161,112356,267805,3.674,12.433,56849,1.859,24.865,9360,9628,48413
2012,53,124729,156091,2316960,2301451,15980,10.241,15875,10.174,307914,89593,218321,3.893,13.379,276446,85128,191318,3.699,12.012,31468,1.367,24.024,9503,9699,45357
2012,54,26548,35697,581836,576361,2659,7.43,2841,7.938,73175,19077,54098,3.31,12.696,62129,19724,42405,3.422,10.78,11046,1.917,21.559,1718,1772,8527
2012,55,96814,126054,2387403,2371571,9919,7.865,10033,7.956,264395,68301,196094,2.88,11.149,232715,67136,165579,2.831,9.813,31680,1.336,19.625,6072,6251,34202
2012,56,15566,18336,212159,209238,1847,10.122,1671,9.157,32133,9670,22463,4.622,15.357,26356,9796,16560,4.682,12.596,5777,2.761,25.192,1061,1093,5451
2013,01,67615,91411,1593772,1587585,7422,8.106,7733,8.445,193368,53679,139689,3.381,12.18,181152,61029,120123,3.844,11.411,12216,0.769,22.821,4786,4873,29083
2013,02,13798,17540,264597,260950,1743,9.973,1619,9.263,34372,9734,24638,3.73,13.172,27230,7272,19958,2.787,10.435,7142,2.737,20.87,927,945,3312
2013,04,88505,118058,2171505,2146746,12945,11.01,11983,10.192,307092,101726,205366,4.739,14.305,258285,83635,174650,3.896,12.031,48807,2.274,24.063,7319,7411,43237
2013,05,45511,59796,976634,975190,5183,8.67,5148,8.612,116847,36699,80148,3.763,11.982,113626,40583,73043,4.162,11.652,3221,0.33,23.303,3322,3435,20049
2013,06,614181,773329,13224020,13016302,83775,10.876,77600,10.075,1963003,634758,1328245,4.877,15.081,1544062,553105,990957,4.249,11.863,418941,3.219,23.725,47985,48850,276971
2013,08,108999,135062,2096512,2063583,15428,11.498,13663,10.183,308613,98569,210044,4.777,14.955,242508,85113,157395,4.125,11.752,66105,3.203,23.504,8322,8411,43394
2013,09,64238,80672,1459099,1458683,6872,8.514,6964,8.628,160413,47251,113162,3.239,10.997,159840,51124,108716,3.505,10.958,573,0.039,21.916,4168,4227,21816
2013,10,16955,21606,372139,367252,2065,9.574,1992,9.235,52202,17134,35068,4.665,14.214,42779,15537,27242,4.231,11.648,9423,2.566,23.297,1127,1139,5404
2013,11,15923,20443,487448,484341,2171,10.731,1749,8.645,57815,19357,38458,3.997,11.937,52234,16157,36077,3.336,10.785,5581,1.152,21.569,866,873,6159
2013,12,361063,451893,7028533,6941535,55588,12.391,49000,10.923,1057191,383424,673767,5.524,15.23,882163,319928,562235,4.609,12.708,175028,2.521,25.417,31277,31717,161081
2013,13,149103,195842,3435979,3399184,20399,10.449,19151,9.81,465935,139989,325946,4.118,13.707,393226,143811,249415,4.231,11.568,72709,2.139,23.136,11660,11842,66834
2013,15,22730,29197,501398,495361,2478,8.5,2390,8.198,60499,19147,41352,3.865,12.213,48392,19457,28935,3.928,9.769,12107,2.444,19.538,1392,1439,10317
2013,16,31308,38088,505797,500292,3955,10.421,3687,9.714,70263,18960,51303,3.79,14.044,59218,24735,34483,4.944,11.837,11045,2.208,23.673,2373,2390,11369
2013,17,219113,279082,5155675,5122875,26201,9.391,26064,9.341,634384,193964,440420,3.786,12.383,570206,190443,379763,3.718,11.131,64178,1.253,22.261,15778,16070,96741
2013,18,97961,132122,2542540,2524108,10244,7.738,10774,8.138,301100,81184,219916,3.216,11.929,264540,78808,185732,3.122,10.481,36560,1.448,20.961,6701,6802,40801
2013,19,55624,73484,1296374,1288461,5335,7.248,5580,7.581,135567,38712,96855,3.005,10.522,119709,31043,88666,2.409,9.291,15858,1.231,18.582,3395,3441,16408
2013,20,52205,67669,1154251,1147338,5392,7.951,5693,8.394,140857,40017,100840,3.488,12.277,127999,43375,84624,3.78,11.156,12858,1.121,22.312,3499,3532,19361
2013,21,61718,83390,1499588,1489220,7311,8.789,6906,8.302,191640,61731,129909,4.145,12.868,170704,52553,118151,3.529,11.463,20936,1.406,22.925,4285,4351,24795
2013,22,74045,96858,1670191,1651313,8082,8.347,8015,8.278,239237,72063,167174,4.364,14.488,200369,74267,126102,4.497,12.134,38868,2.354,24.268,4992,5068,37216
2013,23,28121,35041,483740,484491,3048,8.694,3087,8.805,54333,16169,38164,3.337,11.214,55658,19776,35882,4.082,11.488,-1325,-0.273,22.429,1782,1815,9587
2013,24,95932,122669,2175054,2159550,11451,9.357,10879,8.889,281124,91131,189993,4.22,13.018,250626,82923,167703,3.84,11.605,30498,1.412,23.211,6405,6561,44384
2013,25,122948,155432,3079187,3055639,13670,8.814,13001,8.382,347624,100222,247402,3.28,11.376,300281,95355,204926,3.121,9.827,47343,1.549,19.654,7630,7778,41223
2013,26,151310,195607,3515002,3479340,16375,8.368,16533,8.449,435612,125561,310051,3.609,12.52,364251,110888,253363,3.187,10.469,71361,2.051,20.938,10271,10391,59430
2013,27,100460,128981,2505774,2486963,11142,8.656,10625,8.254,301420,78991,222429,3.176,12.12,264668,71309,193359,2.867,10.642,36752,1.478,21.284,6399,6457,35780
2013,28,41082,54786,896567,895185,4217,7.684,4402,8.021,96848,29016,67832,3.241,10.819,93796,27147,66649,3.033,10.478,3052,0.341,20.956,2857,2905,16582
2013,29,103240,135610,2346799,2330001,13780,10.225,12092,8.973,278966,87597,191369,3.76,11.973,244876,77968,166908,3.346,10.51,34090,1.463,21.019,7577,7740,37237
2013,30,26944,31769,348507,344965,3177,10.035,2956,9.337,44964,13668,31296,3.962,13.034,37905,12801,25104,3.711,10.988,7059,2.046,21.976,1868,1895,7739
2013,31,37386,47587,777587,776528,3812,8.02,3699,7.782,87024,23736,63288,3.057,11.207,85226,26216,59010,3.376,10.975,1798,0.232,21.951,2273,2299,12755
2013,32,41463,53236,1040751,1026821,6488,12.257,5884,11.116,155687,54852,100835,5.342,15.162,128278,48633,79645,4.736,12.493,27409,2.669,24.985,3818,3908,25200
2013,33,27354,34005,549722,548672,2860,8.417,2804,8.253,63006,19208,43798,3.501,11.483,60614,19993,40621,3.644,11.047,2392,0.436,22.095,1757,1773,8455
2013,34,171211,206338,3472776,3451397,20719,10.055,20140,9.774,466466,135454,331012,3.925,13.515,424687,146018,278669,4.231,12.305,41779,1.21,24.61,12982,13181,73688
2013,35,31486,40187,591902,591886,3590,8.919,3718,9.237,79042,27838,51204,4.703,13.354,78796,25222,53574,4.261,13.313,246,0.042,26.625,2339,2376,13101
2013,36,396471,471196,7628236,7567565,48699,10.363,46152,9.821,976034,308287,667747,4.074,12.898,854008,286361,567647,3.784,11.285,122026,1.612,22.57,30150,30617,157990
2013,37,149325,199181,3384339,3354529,18830,9.471,18107,9.107,440081,144150,295931,4.297,13.119,379611,126868,252743,3.782,11.316,60470,1.803,22.633,11241,11401,58328
2013,38,17381,21510,343002,337843,2258,10.633,1708,8.043,51769,17717,34052,5.244,15.323,41733,15186,26547,4.495,12.353,10036,2.971,24.706,1122,1125,7172
2013,39,167610,230269,4546045,4533846,17993,7.802,18708,8.112,542048,151639,390409,3.345,11.956,516917,173266,343651,3.822,11.401,25131,0.554,22.803,11036,11293,67196
2013,40,65522,84237,1319173,1306338,7623,9.079,7078,8.43,175513,57376,118137,4.392,13.435,149725,50653,99072,3.877,11.461,25788,1.974,22.923,4485,4601,27354
2013,41,78383,97852,1391598,1378498,9727,9.993,8697,8.935,178296,50473,127823,3.661,12.934,152905,54343,98562,3.942,11.092,25391,1.842,22.184,5333,5417,24545
2013,42,207673,274875,5156412,5150681,22254,8.103,21768,7.926,587998,180437,407561,3.503,11.416,577438,171080,406358,3.322,11.211,10560,0.205,22.422,13013,13195,87483
2013,44,21075,25090,408460,406223,2150,8.552,2252,8.957,45371,12843,32528,3.162,11.169,40612,12548,28064,3.089,9.997,4759,1.172,19.995,1385,1402,7019
2013,45,70453,93571,1580304,1567050,8321,8.906,8036,8.601,194251,58820,135431,3.754,12.396,167389,50786,116603,3.241,10.682,26862,1.714,21.364,5035,5147,25023
2013,46,19280,23521,339467,335632,1918,8.176,1796,7.656,40238,10186,30052,3.035,11.989,32754,9571,23183,2.852,9.759,7484,2.23,19.518,1151,1159,5496
2013,47,88530,122294,2392592,2372411,10830,8.872,10374,8.499,313516,91947,221569,3.876,13.215,272647,86036,186611,3.627,11.492,40869,1.723,22.985,6439,6596,37648
2013,48,368969,501068,9596491,9450337,52761,10.615,44668,8.987,1449203,460599,988604,4.874,15.335,1156560,394063,762497,4.17,12.238,292643,3.097,24.477,27582,28161,174449
2013,49,50824,62522,1093325,1073702,7442,12.029,6129,9.907,159516,56307,103209,5.244,14.857,121335,41598,79737,3.874,11.301,38181,3.556,22.601,3747,3792,21333
2013,50,15943,18855,256613,260330,1434,7.587,1524,8.063,28332,7685,20647,2.952,10.883,35318,16765,18553,6.44,13.567,-6986,-2.684,21.766,962,962,13645
2013,51,133237,177476,3108209,3093307,16931,9.563,16067,9.075,407631,131420,276211,4.249,13.178,379030,119668,259362,3.869,12.253,28601,0.925,24.506,9224,9393,50920
2013,53,126032,157448,2402059,2369408,16495,10.523,15092,9.628,342040,114785,227255,4.844,14.436,276718,92924,183794,3.922,11.679,65322,2.757,23.358,9298,9439,43132
2013,54,26051,35240,577404,578658,2529,7.133,2957,8.34,66224,18650,47574,3.223,11.444,68664,23273,45391,4.022,11.866,-2440,-0.422,22.889,1810,1832,9707
2013,55,96160,125566,2411820,2399444,9529,7.575,9990,7.941,257755,66297,191458,2.763,10.742,232908,66780,166128,2.783,9.707,24847,1.036,19.413,5976,6079,33276
2013,56,15518,18333,211226,211562,1737,9.477,1730,9.438,27246,8854,18392,4.185,12.879,27885,9138,18747,4.319,13.181,-639,-0.302,25.757,1111,1123,5070
2014,01,67532,91874,1599215,1594994,7387,8.06,6943,7.575,190107,59957,130150,3.759,11.919,182026,52506,129520,3.292,11.412,8081,0.507,22.825,4476,4597,25947
2014,02,13823,17723,264099,263613,1752,9.936,1572,8.915,37038,12972,24066,4.921,14.05,35954,10101,25853,3.832,13.639,1084,0.411,27.278,948,955,3898
2014,04,89444,120098,2226168,2199855,13263,11.137,11243,9.441,338157,113773,224384,5.172,15.372,285166,84135,201031,3.825,12.963,52991,2.409,25.926,7213,7342,43024
2014,05,45407,59851,986218,981686,4852,8.111,4794,8.014,113773,35633,78140,3.63,11.59,104763,37165,67598,3.786,10.672,9010,0.918,21.343,3214,3271,16094
2014,06,625398,788711,13605135,13408071,87917,11.256,72573,9.292,1988145,653896,1334249,4.877,14.828,1598459,541853,1056606,4.041,11.922,389686,2.906,23.843,47321,48224,271808
2014,08,111074,138045,2178005,2136495,16072,11.77,13092,9.587,326126,107566,218560,5.035,15.265,242509,79143,163366,3.704,11.351,83617,3.914,22.702,8381,8454,40652
2014,09,64066,80932,1478061,1468958,6850,8.477,6609,8.178,168647,51117,117530,3.48,11.481,151125,49095,102030,3.342,10.288,17522,1.193,20.576,4147,4187,19843
2014,10,17092,21746,387847,382697,2071,9.556,1925,8.882,55123,14997,40126,3.919,14.404,44663,13570,31093,3.546,11.671,10460,2.733,23.341,1115,1137,5523
2014,11,16072,20707,493657,490228,1995,9.697,1729,8.404,59947,20232,39715,4.127,12.228,53016,14555,38461,2.969,10.815,6931,1.414,21.629,933,947,5919
2014,12,367119,460653,7281905,7156349,56852,12.46,48107,10.543,1136822,402523,734299,5.625,15.886,884570,307323,577247,4.294,12.361,252252,3.525,24.721,31892,32425,171756
2014,13,150392,198624,3511596,3473775,21055,10.675,18292,9.274,474535,146980,327555,4.231,13.661,396691,147497,249194,4.246,11.42,77844,2.241,22.839,11722,11931,84284
2014,15,22717,29415,518364,509849,2461,8.397,2247,7.667,63102,23255,39847,4.561,12.377,46468,14656,31812,2.875,9.114,16634,3.263,18.228,1486,1503,8042
2014,16,32001,38991,530898,518100,4181,10.849,3278,8.506,77039,22231,54808,4.291,14.87,51967,15667,36300,3.024,10.03,25072,4.839,20.061,2155,2196,9252
2014,17,219174,280173,5252969,5204624,25910,9.265,24857,8.889,635233,191235,443998,3.674,12.205,537879,181029,356850,3.478,10.335,97354,1.871,20.669,15552,15816,83207
2014,18,97382,132163,2599615,2570905,10565,7.995,10522,7.963,307721,85807,221914,3.338,11.969,250793,77509,173284,3.015,9.755,56928,2.214,19.51,6581,6699,39441
2014,19,55543,73578,1304939,1300654,5239,7.125,5148,7.001,124149,36591,87558,2.813,9.545,115499,34300,81199,2.637,8.88,8650,0.665,17.76,3292,3388,17110
2014,20,52368,68105,1176445,1164812,5669,8.351,5229,7.703,144036,47069,96967,4.041,12.366,120543,34192,86351,2.935,10.349,23493,2.017,20.697,3327,3404,18202
2014,21,62249,84496,1530037,1515278,7743,9.223,6662,7.935,197922,66290,131632,4.375,13.062,166896,46532,120364,3.071,11.014,31026,2.048,22.028,4234,4333,23632
2014,22,74112,97505,1703157,1689507,8209,8.447,7570,7.789,211560,67894,143666,4.019,12.522,183893,56073,127820,3.319,10.884,27667,1.638,21.769,4872,4968,27336
2014,23,28212,35278,490936,487435,3116,8.862,2882,8.197,55840,20478,35362,4.201,11.456,48811,14501,34310,2.975,10.014,7029,1.442,20.028,1757,1785,7122
2014,24,96148,123779,2203042,2188448,11726,9.516,10629,8.625,260054,79444,180610,3.63,11.883,231529,64673,166856,2.955,10.58,28525,1.303,21.159,6528,6599,32647
2014,25,123727,156759,3090317,3077783,13576,8.697,12248,7.847,336966,105101,231865,3.415,10.948,314098,82607,231491,2.684,10.205,22868,0.743,20.411,7682,7893,42631
2014,26,151300,196268,3591369,3551014,16485,8.414,15818,8.073,441111,124150,316961,3.496,12.422,358880,114518,244362,3.225,10.106,82231,2.316,20.213,10177,10400,62231
2014,27,101020,130551,2556038,2530647,11497,8.859,9960,7.674,284118,78931,205187,3.119,11.227,233001,66335,166666,2.621,9.207,51117,2.02,18.414,6324,6463,40832
2014,28,41042,55031,907227,901885,4374,7.965,4139,7.537,98911,30832,68079,3.419,10.967,88212,25165,63047,2.79,9.781,10699,1.186,19.562,2780,2834,14178
2014,29,105569,138704,2394006,2370967,14946,10.887,12094,8.81,279297,83793,195504,3.534,11.78,232507,71060,161447,2.997,9.806,46790,1.973,19.613,8032,8142,37400
2014,30,27095,32077,361476,354974,3111,9.745,2806,8.789,48371,14460,33911,4.074,13.627,35340,10904,24436,3.072,9.956,13031,3.671,19.911,1838,1853,7609
2014,31,37850,48241,794258,786047,3956,8.255,3314,6.916,86400,24823,61577,3.158,10.992,69694,21208,48486,2.698,8.866,16706,2.125,17.733,2075,2134,10322
2014,32,42476,54663,1084801,1064020,6930,12.845,5507,10.207,151424,51151,100273,4.807,14.231,109301,39568,69733,3.719,10.272,42123,3.959,20.545,3639,3677,21443
2014,33,27281,34246,562806,556124,2906,8.515,2670,7.823,65157,25238,39919,4.538,11.716,51006,15638,35368,2.812,9.172,14151,2.545,18.343,1712,1752,8268
2014,34,171189,207185,3503661,3488453,20668,9.996,19826,9.589,437545,147985,289560,4.242,12.543,406232,125557,280675,3.599,11.645,31313,0.898,23.29,13169,13349,68652
2014,35,31309,40221,615362,603668,3502,8.71,3469,8.628,87779,40126,47653,6.647,14.541,65317,19970,45347,3.308,10.82,22462,3.721,21.64,2294,2321,10824
2014,36,399091,475472,7814067,7726937,49318,10.419,45051,9.518,1013692,348106,665586,4.505,13.119,840001,273842,566159,3.544,10.871,173691,2.248,21.742,30962,31287,156835
2014,37,149766,200431,3443803,3414556,18693,9.355,17448,8.732,417219,128446,288773,3.762,12.219,359834,124806,235028,3.655,10.538,57385,1.681,21.076,11096,11337,57909
2014,38,17764,22133,359742,351294,2291,10.497,1674,7.67,54039,18883,35156,5.375,15.383,36903,10454,26449,2.976,10.505,17136,4.878,21.01,1157,1165,5295
2014,39,166893,230974,4604200,4576670,17940,7.778,17268,7.487,523262,157627,365635,3.444,11.433,468245,127306,340939,2.782,10.231,55017,1.202,20.462,10575,10889,63563
2014,40,65876,85047,1353290,1335546,7615,8.996,6814,8.05,179042,55495,123547,4.155,13.406,143418,47298,96120,3.541,10.739,35624,2.667,21.477,4582,4647,27211
2014,41,79424,99390,1433591,1412759,9857,9.994,8332,8.448,185201,56129,129072,3.973,13.109,143999,43984,100015,3.113,10.193,41202,2.916,20.386,5394,5465,23296
2014,42,207257,275398,5227899,5192599,21963,7.983,21437,7.791,578577,178771,399806,3.443,11.142,509989,157077,352912,3.025,9.821,68588,1.321,19.643,13099,13425,76437
2014,44,20993,25181,420454,414391,2219,8.828,2127,8.462,50993,17438,33555,4.208,12.306,38777,11989,26788,2.893,9.358,12216,2.948,18.715,1364,1374,6784
2014,45,70750,94335,1611103,1589562,8605,9.159,7841,8.346,200896,62533,138363,3.934,12.638,157710,48833,108877,3.072,9.922,43186,2.717,19.843,5052,5147,25426
2014,46,19331,23636,347188,343322,1886,7.999,1771,7.511,38901,11589,27312,3.376,11.331,31031,8501,22530,2.476,9.038,7870,2.292,18.077,1181,1201,5434
2014,47,88491,123167,2450279,2422141,10854,8.843,10004,8.15,297194,91354,205840,3.772,12.27,240202,71041,169161,2.933,9.917,56992,2.353,19.834,6394,6516,36099
2014,48,375819,512232,9899817,9750571,54797,10.815,43658,8.617,1452790,493552,959238,5.062,14.9,1152930,388734,764196,3.987,11.824,299860,3.075,23.648,27907,28628,179463
2014,49,52070,64053,1142380,1121081,7601,12.01,6074,9.597,166155,55072,111083,4.912,14.821,122793,38646,84147,3.447,10.953,43362,3.868,21.906,3894,3954,22247
2014,50,15939,18882,261347,259547,1521,8.06,1499,7.943,28462,8360,20102,3.221,10.966,24954,7787,17167,3.0,9.614,3508,1.352,19.229,965,999,5449
2014,51,133682,179137,3133748,3120576,16752,9.395,15105,8.471,385464,126343,259121,4.049,12.352,357540,103044,254496,3.302,11.458,27924,0.895,22.915,9520,9675,44972
2014,53,127879,160024,2478110,2440275,16549,10.425,13993,8.815,324057,96938,227119,3.972,13.28,247334,74161,173173,3.039,10.135,76723,3.144,20.271,9055,9185,41093
2014,54,25519,34856,573637,575395,2424,6.915,2818,8.039,63739,20424,43315,3.55,11.077,66876,20551,46325,3.572,11.623,-3137,-0.545,22.155,1790,1818,9120
2014,55,96217,126177,2441257,2415916,9716,7.718,9130,7.253,258809,72177,186632,2.988,10.713,208385,58830,149555,2.435,8.626,50424,2.087,17.251,5755,5882,29921
2014,56,15568,18475,218425,214825,1718,9.336,1571,8.537,30579,8659,21920,4.031,14.234,23209,6139,17070,2.858,10.804,7370,3.431,21.607,1054,1057,3617
2015,01,67460,92459,1630927,1614556,7715,8.371,7134,7.74,197604,62409,135195,3.865,12.239,165340,54125,111215,3.352,10.241,32264,1.998,20.481,4558,4714,26501
2015,02,13923,17907,266122,265050,1755,9.852,1568,8.802,35791,10405,25386,3.926,13.504,33896,9352,24544,3.528,12.789,1895,0.715,25.577,956,968,4214
2015,04,90727,121814,2298170,2264912,13257,10.961,11532,9.534,328518,110584,217934,4.882,14.505,261626,85603,176023,3.78,11.551,66892,2.953,23.103,7100,7292,40879
2015,05,45342,60100,999207,992913,5070,8.453,4831,8.054,119878,38308,81570,3.858,12.073,107735,35410,72325,3.566,10.85,12143,1.223,21.701,3072,3137,17143
2015,06,635564,802909,14071407,13842716,88647,11.14,74316,9.339,2008491,669707,1338784,4.838,14.509,1549446,525351,1024095,3.795,11.193,459045,3.316,22.386,48923,49845,299335
2015,08,113258,140879,2253120,2211795,16598,11.903,13729,9.845,329010,108544,220466,4.908,14.875,246167,88074,158093,3.982,11.13,82843,3.746,22.259,8703,8803,44995
2015,09,63841,81057,1498030,1489610,6799,8.395,6669,8.234,175379,57789,117590,3.879,11.773,158942,45698,113244,3.068,10.67,16437,1.103,21.34,4078,4137,23352
2015,10,17291,22011,395754,392062,2229,10.186,1972,9.012,54255,17447,36808,4.45,13.838,46538,15328,31210,3.91,11.87,7717,1.968,23.74,1134,1154,6259
2015,11,16284,20921,507504,500505,2177,10.461,1957,9.404,74297,27065,47232,5.408,14.844,59388,18255,41133,3.647,11.866,14909,2.979,23.731,977,990,7505
2015,12,375225,471393,7611297,7452149,58850,12.628,48108,10.323,1157256,405377,751879,5.44,15.529,836814,322776,514038,4.331,11.229,320442,4.3,22.458,31524,32163,178619
2015,13,152509,201801,3666917,3596515,21493,10.735,18307,9.144,535379,177112,358267,4.925,14.886,394433,134642,259791,3.744,10.967,140946,3.919,21.934,11453,11750,72046
2015,15,22743,29554,523104,520682,2475,8.395,2328,7.897,55323,17434,37889,3.348,10.625,50939,16147,34792,3.101,9.783,4384,0.842,19.566,1480,1499,9332
2015,16,32543,39780,549503,540492,4175,10.599,3393,8.614,72219,21778,50441,4.029,13.362,54578,19207,35371,3.554,10.098,17641,3.264,20.196,2218,2250,10038
2015,17,220613,282380,5364438,5293469,26547,9.438,24333,8.651,709885,202266,507619,3.821,13.411,565141,181901,383240,3.436,10.676,144744,2.734,21.352,15041,15444,84282
2015,18,97683,133633,2663709,2631045,11346,8.538,9872,7.428,324826,95276,229550,3.621,12.346,258564,69182,189382,2.629,9.827,66262,2.518,19.655,6137,6327,36702
2015,19,55786,74159,1329995,1317698,5670,7.674,5123,6.934,143211,41959,101252,3.184,10.868,117555,32234,85321,2.446,8.921,25656,1.947,17.842,3205,3279,15786
2015,20,52373,68439,1188884,1181730,5704,8.356,5356,7.846,149202,47779,101423,4.043,12.626,135646,36646,99000,3.101,11.479,13556,1.147,22.957,3418,3530,18761
2015,21,62220,85114,1577865,1554645,7231,8.529,6563,7.741,196713,57119,139594,3.674,12.653,150358,43649,106709,2.808,9.672,46355,2.982,19.343,4226,4296,22671
2015,22,73994,97990,1716283,1709255,8354,8.547,7858,8.04,225786,74764,151022,4.374,13.21,213938,55468,158470,3.245,12.516,11848,0.693,25.033,5036,5135,29358
2015,23,28400,35611,499729,495271,3168,8.939,2827,7.977,57450,17232,40218,3.479,11.6,48339,15915,32424,3.213,9.76,9111,1.84,19.52,1762,1793,7676
2015,24,96334,124284,2230587,2216842,11245,9.067,10728,8.65,268143,90658,177485,4.09,12.096,239845,73556,166289,3.318,10.819,28298,1.277,21.638,6570,6685,35504
2015,25,124292,157806,3172905,3131478,13716,8.721,12655,8.046,372145,112195,259950,3.583,11.884,288291,91042,197249,2.907,9.206,83854,2.678,18.412,7738,7887,45217
2015,26,151997,198194,3716131,3659536,17798,9.025,15846,8.035,475597,145696,329901,3.981,12.996,361519,105864,255655,2.893,9.879,114078,3.117,19.758,10129,10397,60343
2015,27,101622,131881,2577660,2555381,11657,8.884,10330,7.872,298497,89233,209264,3.492,11.681,254197,71787,182410,2.809,9.948,44300,1.734,19.895,6440,6639,37556
2015,28,40863,55014,924129,915723,4253,7.729,4272,7.764,112888,41854,71034,4.571,12.328,95301,26832,68469,2.93,10.407,17587,1.921,20.814,2824,2880,16176
2015,29,107682,141340,2435030,2414028,15347,10.962,12673,9.052,306850,105865,200985,4.385,12.711,265325,86809,178516,3.596,10.991,41525,1.72,21.982,8191,8400,41462
2015,30,27474,32535,371438,366488,3179,9.838,2734,8.461,48605,15040,33565,4.104,13.262,38189,12104,26085,3.303,10.42,10416,2.842,20.841,1840,1881,7380
2015,31,38150,48896,810749,801830,4123,8.487,3492,7.188,92460,29367,63093,3.662,11.531,75104,21870,53234,2.728,9.367,17356,2.165,18.733,2194,2232,11290
2015,32,43575,56296,1124603,1104660,7137,12.862,5523,9.953,164987,66691,98296,6.037,14.936,124082,38515,85567,3.487,11.233,40905,3.703,22.465,3671,3744,22961
2015,33,27277,34398,577095,569893,2818,8.21,2668,7.773,65344,18718,46626,3.284,11.466,51053,13948,37105,2.447,8.958,14291,2.508,17.917,1698,1726,8134
2015,34,170537,207146,3543291,3520786,20002,9.656,20012,9.661,469047,161057,307990,4.574,13.322,422083,141795,280288,4.027,11.988,46964,1.334,23.977,13345,13544,82348
2015,35,31184,40378,626044,620186,3646,9.048,3486,8.651,77350,27085,50265,4.367,12.472,65556,19485,46071,3.142,10.57,11794,1.902,21.141,2208,2229,10247
2015,36,400974,478017,7967520,7890375,48220,10.115,45632,9.572,1031348,345247,686101,4.376,13.071,878207,288416,589791,3.655,11.13,153141,1.941,22.26,30898,31377,157185
2015,37,151573,203111,3557950,3499833,19309,9.571,16595,8.225,461882,150584,311298,4.303,13.197,346534,113734,232800,3.25,9.901,115348,3.296,19.803,10298,10469,59389
2015,38,17992,22533,365169,362463,2207,9.881,1813,8.117,46225,17292,28933,4.771,12.753,40902,10352,30550,2.856,11.284,5323,1.469,22.569,1258,1280,6676
2015,39,166736,232539,4680408,4643412,19075,8.231,17496,7.55,559087,170069,389018,3.663,12.04,484872,141098,343774,3.039,10.442,74215,1.598,20.884,10484,10789,71934
2015,40,65930,85615,1366827,1359731,7765,9.1,7198,8.435,172121,58312,113809,4.288,12.658,159223,53145,106078,3.908,11.71,12898,0.949,23.42,4800,4890,25494
2015,41,81002,101694,1494395,1464824,10318,10.263,8006,7.963,202055,61985,140070,4.232,13.794,142814,45588,97226,3.112,9.75,59241,4.044,19.499,5163,5220,25260
2015,42,207063,276258,5288783,5260769,22367,8.109,21518,7.801,606493,204985,401508,3.896,11.529,549114,169368,379746,3.219,10.438,57379,1.091,20.876,12952,13321,75233
2015,44,21176,25400,425190,422510,2298,9.087,2073,8.198,46283,13507,32776,3.197,10.954,40595,11864,28731,2.808,9.608,5688,1.346,19.216,1259,1280,7340
2015,45,71679,95767,1662255,1637836,9096,9.571,7636,8.035,211534,70539,140995,4.307,12.915,163348,51486,111862,3.144,9.973,48186,2.942,19.947,4937,5033,27434
2015,46,19562,24003,352744,349834,2076,8.714,1718,7.211,36703,11196,25507,3.2,10.492,30968,9667,21301,2.763,8.852,5735,1.639,17.704,1163,1188,5966
2015,47,88733,124565,2499910,2472767,11230,9.067,9818,7.927,308287,99539,208748,4.025,12.467,254231,78070,176161,3.157,10.281,54056,2.186,20.562,6275,6430,46433
2015,48,382240,521787,10236231,10078078,55207,10.678,45643,8.828,1500879,515737,985142,5.117,14.893,1184911,382929,801982,3.8,11.757,315968,3.135,23.515,29101,29965,187963
2015,49,53277,65796,1202105,1175422,7889,12.151,6149,9.471,181670,60017,121653,5.106,15.456,127892,38930,88962,3.312,10.881,53778,4.575,21.761,4027,4121,23550
2015,50,15994,19023,267108,264220,1493,7.878,1351,7.129,28785,8192,20593,3.1,10.894,22877,6099,16778,2.308,8.658,5908,2.236,17.317,910,921,3761
2015,51,134680,180764,3202625,3172825,16989,9.441,15359,8.535,406349,139387,266962,4.393,12.807,347282,107584,239698,3.391,10.946,59067,1.862,21.891,9313,9501,48097
2015,53,130238,163412,2558270,2516752,17408,10.765,14006,8.661,346376,114072,232304,4.533,13.763,263006,75531,187475,3.001,10.45,83370,3.313,20.9,9232,9377,44216
2015,54,25267,34745,566821,570805,2616,7.517,2732,7.85,60497,18705,41792,3.277,10.599,67754,18090,49664,3.169,11.87,-7257,-1.271,21.197,1747,1779,9160
2015,55,96679,127321,2492239,2467049,10101,7.97,8943,7.056,272631,74831,197800,3.033,11.051,220776,59128,161648,2.397,8.949,51855,2.102,17.898,5732,5837,32247
2015,56,15811,18739,218964,218547,1825,9.807,1564,8.405,28577,9497,19080,4.346,13.076,27777,7737,20040,3.54,12.71,800,0.366,25.42,1031,1035,3763
2016,01,68120,93773,1672186,1651952,7719,8.29,6390,6.863,199512,66194,133318,4.007,12.077,157689,45617,112072,2.761,9.546,41823,2.532,19.091,4277,4396,24096
2016,02,14037,18119,264304,265323,1832,10.17,1622,9.004,34242,11907,22335,4.488,12.906,36326,10905,25421,4.11,13.691,-2084,-0.785,25.812,1015,1037,6387
2016,04,92498,124763,2374402,2337134,13715,11.124,10778,8.742,357439,118565,238874,5.073,15.294,283197,104629,178568,4.477,12.117,74242,3.177,24.235,6962,7171,56397
2016,05,45674,60946,1020934,1010016,5436,8.982,4587,7.579,123148,41287,81861,4.088,12.193,101373,27866,73507,2.759,10.037,21775,2.156,20.074,3119,3164,17289
2016,06,647468,819814,14358897,14204504,91450,11.271,74553,9.189,2033461,649017,1384444,4.569,14.316,1717040,645446,1071594,4.544,12.088,316421,2.228,24.176,50632,51657,316989
2016,08,115893,144933,2312823,2283115,17465,12.221,13414,9.386,321400,116984,204416,5.124,14.077,262659,87898,174761,3.85,11.504,58741,2.573,23.009,8769,8922,47520
2016,09,64552,82511,1537156,1517524,7707,9.423,6256,7.649,183687,60637,123050,3.996,12.104,143359,47309,96050,3.118,9.447,40328,2.657,18.894,4087,4134,19780
2016,10,17721,22651,402468,399002,2359,10.562,1725,7.724,53945,16544,37401,4.146,13.52,46944,12767,34177,3.2,11.765,7001,1.755,23.531,1118,1137,6252
2016,11,16555,21580,518334,513242,2280,10.727,1628,7.66,64249,19811,44438,3.86,12.518,54065,12471,41594,2.43,10.534,10184,1.984,21.068,977,1000,5708
2016,12,384655,485603,7855687,7740915,60716,12.689,46525,9.723,1132708,407468,725240,5.264,14.633,905842,337317,568525,4.358,11.702,226866,2.931,23.404,32148,32626,174715
2016,13,155496,206389,3791004,3736179,22093,10.824,17519,8.583,503170,170905,332265,4.574,13.468,393486,133086,260400,3.562,10.532,109684,2.936,21.064,11521,11790,71088
2016,15,22988,30005,528618,525951,2630,8.831,2186,7.34,58408,18459,39949,3.51,11.105,52670,13295,39375,2.528,10.014,5738,1.091,20.028,1425,1470,8063
2016,16,33246,40735,563947,556413,4411,10.96,3436,8.537,76356,24893,51463,4.474,13.723,61172,18366,42806,3.301,10.994,15184,2.729,21.988,2296,2352,10147
2016,17,222307,285492,5417838,5394975,26790,9.435,23702,8.347,652856,208926,443930,3.873,12.101,610050,170850,439200,3.167,11.308,42806,0.793,22.615,15662,16021,85194
2016,18,98254,135829,2724921,2694463,11389,8.452,9225,6.846,319224,97972,221252,3.636,11.847,258332,62967,195365,2.337,9.588,60892,2.26,19.175,6182,6365,37235
2016,19,56007,75014,1348748,1339157,5778,7.746,4936,6.617,136597,39662,96935,2.962,10.2,117467,30568,86899,2.283,8.772,19130,1.429,17.543,3246,3324,17729
2016,20,52620,69303,1189526,1188888,6028,8.752,5172,7.509,131686,45105,86581,3.794,11.076,130574,44266,86308,3.723,10.983,1112,0.094,21.966,3454,3586,23264
2016,21,62279,85701,1607671,1592899,6999,8.195,6405,7.5,191045,57971,133074,3.639,11.994,161531,46946,114585,2.947,10.141,29514,1.853,20.281,4306,4494,24482
2016,22,73955,98774,1701155,1708715,8542,8.682,7764,7.891,199142,72065,127077,4.217,11.654,215125,55455,159670,3.245,12.59,-15983,-0.935,23.309,5272,5395,32621
2016,23,29076,36436,510307,505303,3426,9.51,2602,7.223,56787,18861,37926,3.733,11.238,46790,15381,31409,3.044,9.26,9997,1.978,18.52,1722,1762,8851
2016,24,97443,126323,2277596,2254978,11801,9.418,9755,7.785,270462,83135,187327,3.687,11.994,225610,71530,154080,3.172,10.005,44852,1.989,20.01,6337,6464,35318
2016,25,126510,161264,3237952,3203910,15029,9.42,11578,7.257,370622,107199,263423,3.346,11.568,305275,81830,223445,2.554,9.528,65347,2.04,19.056,7787,7928,45449
2016,26,153470,200896,3799312,3758659,17510,8.775,14795,7.415,457577,135149,322428,3.596,12.174,376061,111226,264835,2.959,10.005,81516,2.169,20.01,10058,10344,69345
2016,27,102505,134034,2626574,2601341,12029,9.048,9860,7.416,316777,97157,219620,3.735,12.177,265435,83220,182215,3.199,10.204,51342,1.974,20.408,6646,6780,45625
2016,28,40904,55338,938433,931527,4421,8.012,4106,7.441,108731,34279,74452,3.68,11.672,95454,27156,68298,2.915,10.247,13277,1.425,20.494,2724,2799,14163
2016,29,109979,144943,2489666,2462149,15680,10.952,12130,8.473,298265,96750,201515,3.929,12.114,242421,73724,168697,2.994,9.846,55844,2.268,19.692,8384,8513,40763
2016,30,27682,32960,375078,373055,3159,9.647,2732,8.343,44220,15939,28281,4.273,11.853,40658,12090,28568,3.241,10.899,3562,0.955,21.797,1891,1898,8097
2016,31,38624,49618,825359,818061,4132,8.389,3409,6.921,88608,27316,61292,3.339,10.831,74341,21595,52746,2.64,9.087,14267,1.744,18.175,2198,2262,12056
2016,32,44719,57965,1158811,1144087,7162,12.535,5501,9.628,156480,55137,101343,4.819,13.677,127747,45411,82336,3.969,11.166,28733,2.511,22.332,3720,3813,29107
2016,33,27620,34970,594168,585740,3011,8.681,2437,7.026,65852,18399,47453,3.141,11.243,49099,13838,35261,2.362,8.382,16753,2.86,16.765,1689,1714,8096
2016,34,171828,209625,3621581,3584585,21083,10.117,18621,8.935,474945,147704,327241,4.121,13.25,399763,131601,268162,3.671,11.152,75182,2.097,22.305,12991,13129,72644
2016,35,31065,40464,629839,628067,3503,8.666,3417,8.454,74689,26868,47821,4.278,11.892,71408,21082,50326,3.357,11.369,3281,0.522,22.739,2241,2316,12069
2016,36,405448,484721,8133111,8050137,50447,10.48,43740,9.087,1014252,311733,702519,3.872,12.599,848979,299243,549736,3.717,10.546,165273,2.053,21.092,31479,31887,185613
2016,37,154678,207855,3669553,3614602,20357,9.907,15619,7.601,475023,151265,323758,4.185,13.142,366902,110794,256108,3.065,10.151,108121,2.991,20.301,10389,10594,67123
2016,38,17794,22528,347395,356576,1908,8.469,1913,8.491,34501,12618,21883,3.539,9.676,52917,10656,42261,2.988,14.84,-18416,-5.165,19.351,1353,1377,6516
2016,39,166880,236059,4773217,4731165,19511,8.327,16019,6.837,549314,165301,384013,3.494,11.611,465999,127044,338955,2.685,9.85,83315,1.761,19.699,10605,10952,69685
2016,40,65647,86140,1356913,1361747,7891,9.189,7367,8.578,164112,57632,106480,4.232,12.052,174626,46564,128062,3.419,12.824,-10514,-0.772,24.103,5079,5170,26527
2016,41,82787,104055,1546810,1521443,10588,10.292,8232,8.002,196281,59442,136839,3.907,12.901,146441,47512,98929,3.123,9.625,49840,3.276,19.25,5478,5577,26747
2016,42,208432,279679,5345589,5318146,23352,8.401,19959,7.18,600724,189083,411641,3.555,11.296,545073,164849,380224,3.1,10.249,55651,1.046,20.499,12952,13289,79338
2016,44,21510,25959,434035,429469,2531,9.856,1975,7.691,50008,16393,33615,3.817,11.644,41168,11179,29989,2.603,9.586,8840,2.058,19.172,1321,1336,6789
2016,45,73038,98116,1718512,1691236,9451,9.749,7106,7.33,225349,76595,148754,4.529,13.325,170940,50995,119945,3.015,10.107,54409,3.217,20.215,4798,4932,27352
2016,46,19750,24389,358176,355539,2087,8.625,1706,7.05,35799,10522,25277,2.959,10.069,30705,7705,23000,2.167,8.636,5094,1.433,17.272,1198,1213,5042
2016,47,89668,126890,2581202,2540131,11368,9.041,9055,7.202,321114,102652,218462,4.041,12.642,238729,68131,170598,2.682,9.398,82385,3.243,18.797,6098,6253,35814
2016,48,388173,533560,10429976,10333516,57368,10.872,45604,8.642,1443572,509694,933878,4.932,13.97,1251350,355747,895603,3.443,12.11,192222,1.86,24.219,30817,31773,201632
2016,49,54490,67574,1246086,1224724,7949,11.92,6178,9.264,170775,52644,118131,4.298,13.944,128287,42507,85780,3.471,10.475,42488,3.469,20.95,4120,4206,24123
2016,50,16017,19121,266971,267062,1489,7.807,1393,7.304,26273,7113,19160,2.663,9.838,26641,6637,20004,2.485,9.976,-368,-0.138,19.676,924,936,3907
2016,51,135978,183558,3264535,3234812,17404,9.554,14628,8.03,407267,131590,275677,4.068,12.59,348143,101759,246384,3.146,10.762,59124,1.828,21.525,9451,9691,49933
2016,53,132594,166830,2614841,2571372,17716,10.73,14284,8.651,349760,110501,239259,4.297,13.602,263507,87321,176186,3.396,10.248,86253,3.354,20.495,9566,9681,47048
2016,54,24966,34601,560348,563471,2490,7.181,2635,7.599,61859,19276,42583,3.421,10.978,68276,18068,50208,3.207,12.117,-6417,-1.139,21.956,1794,1855,11435
2016,55,97735,129949,2522816,2507701,11297,8.782,8674,6.743,277071,90312,186759,3.601,11.049,246409,64271,182138,2.563,9.826,30662,1.223,19.652,5732,5858,32411
2016,56,15629,18675,207629,213279,1789,9.563,1853,9.905,23737,9110,14627,4.271,11.13,35064,9870,25194,4.628,16.44,-11327,-5.311,22.259,1325,1336,6356
2017,01,68250,93828,1695699,1682207,7465,7.959,7403,7.893,219900,54906,164994,3.264,13.072,192225,58383,133842,3.471,11.427,27675,1.645,22.854,4608,4742,28726
2017,02,13979,18045,259701,261544,1733,9.586,1800,9.957,33997,8448,25549,3.23,12.999,37563,12660,24903,4.84,14.362,-3566,-1.363,25.997,1084,1101,5163
2017,04,94019,126630,2437763,2404358,13684,10.887,11808,9.394,356656,115312,241344,4.796,14.834,289913,100710,189203,4.189,12.058,66743,2.776,24.116,7316,7476,45969
2017,05,45772,61243,1025955,1019146,5184,8.487,4868,7.969,133063,39427,93636,3.869,13.056,119249,36553,82696,3.587,11.701,13814,1.355,23.402,3092,3187,17920
2017,06,655518,828905,14660360,14497598,89130,10.813,79909,9.694,2148256,661562,1486694,4.563,14.818,1822397,633838,1188559,4.372,12.57,325859,2.248,25.141,52808,54044,342972
2017,08,118087,147335,2367047,2341263,16899,11.566,14458,9.895,341917,117596,224321,5.023,14.604,289987,102425,187562,4.375,12.386,51930,2.218,24.772,9107,9249,50849
2017,09,63683,81631,1527702,1526460,6234,7.597,7088,8.638,185383,59741,125642,3.914,12.145,181839,75491,106348,4.945,11.912,3544,0.232,23.825,4326,4427,32984
2017,10,17810,22695,398520,400092,2234,9.853,2189,9.655,53829,15993,37836,3.997,13.454,56601,20099,36502,5.024,14.147,-2772,-0.693,26.908,1304,1323,6146
2017,11,16692,21774,524968,521429,1993,9.195,1795,8.281,62078,18229,43849,3.496,11.905,55491,19713,35778,3.781,10.642,6587,1.263,21.284,1020,1032,6939
2017,12,390923,491895,7993227,7892233,58132,11.895,51793,10.598,1168648,372849,795799,4.724,14.808,966871,362551,604320,4.594,12.251,201777,2.557,24.502,34016,34561,188878
2017,13,157739,209150,3870303,3827245,21611,10.402,18831,9.064,550663,179097,371566,4.68,14.388,462508,155748,306760,4.069,12.085,88155,2.303,24.169,12022,12293,71745
2017,15,23006,30076,542269,535343,2474,8.236,2399,7.986,71859,27521,44338,5.141,13.423,58191,15942,42249,2.978,10.87,13668,2.553,21.74,1549,1573,8181
2017,16,33778,41349,577157,569977,4330,10.552,3702,9.022,78607,23904,54703,4.194,13.791,64332,20682,43650,3.629,11.287,14275,2.504,22.574,2357,2401,10891
2017,17,222120,285332,5402960,5405081,25425,8.908,25574,8.961,658350,193731,464619,3.584,12.18,663049,233916,429133,4.328,12.267,-4699,-0.087,24.36,15950,16456,112970
2017,18,98589,136283,2770107,2745590,10645,7.824,10187,7.487,347481,90012,257469,3.278,12.656,298771,89104,209667,3.245,10.882,48710,1.774,21.764,6170,6333,44290
2017,19,55899,74901,1350636,1348671,5558,7.416,5646,7.534,149976,37170,112806,2.756,11.12,147598,41876,105722,3.105,10.944,2378,0.176,21.888,3407,3470,18638
2017,20,52243,68931,1194742,1189076,5504,7.965,5849,8.464,148719,45126,103593,3.795,12.507,137354,45359,91995,3.815,11.551,11365,0.956,23.103,3730,3844,22036
2017,21,61829,85198,1623233,1612466,6798,7.956,7282,8.523,206073,60202,145871,3.734,12.78,185679,63758,121921,3.954,11.515,20394,1.265,23.03,4742,4806,31632
2017,22,73679,98273,1682442,1690302,7820,7.938,8313,8.438,210425,59983,150442,3.549,12.449,225897,66562,159335,3.938,13.364,-15472,-0.915,24.898,5118,5232,32373
2017,23,29109,36428,512689,510897,3017,8.281,3024,8.301,58404,15431,42973,3.02,11.432,55079,17963,37116,3.516,10.781,3325,0.651,21.562,1926,1967,9274
2017,24,97535,126353,2328818,2302079,11074,8.765,11043,8.741,312315,86476,225839,3.756,13.567,260311,82205,178106,3.571,11.308,52004,2.259,22.615,6767,6890,38359
2017,25,127187,162183,3293149,3275153,14119,8.73,13195,8.159,398232,112148,286084,3.424,12.159,362927,112238,250689,3.427,11.081,35305,1.078,22.162,8245,8459,55197
2017,26,153207,200481,3846783,3820213,16009,7.977,16425,8.184,469793,122040,347753,3.195,12.298,417302,135349,281953,3.543,10.924,52491,1.374,21.847,10394,10759,67989
2017,27,102803,134446,2654688,2638561,11426,8.512,11003,8.197,328384,105319,223065,3.992,12.446,297190,94531,202659,3.583,11.263,31194,1.182,22.527,6915,7083,43089
2017,28,40780,55272,935017,934765,4334,7.838,4379,7.919,105569,30373,75196,3.249,11.294,104493,30575,73918,3.271,11.179,1076,0.115,22.357,2779,2853,14801
2017,29,110060,144732,2517943,2499325,14433,9.976,14318,9.897,322843,100849,221994,4.035,12.917,286393,99500,186893,3.981,11.459,36450,1.458,22.918,9178,9391,46464
2017,30,27752,33039,376283,375342,2947,8.932,2856,8.656,48345,13673,34672,3.643,12.88,45949,14400,31549,3.837,12.242,2396,0.638,24.484,1857,1895,8629
2017,31,38843,49871,830896,827264,4068,8.18,3792,7.625,98350,28024,70326,3.388,11.889,90745,31412,59333,3.797,10.969,7605,0.919,21.939,2379,2435,16390
2017,32,45314,58698,1188366,1172194,6823,11.698,6084,10.431,168454,53043,115411,4.525,14.371,137325,50970,86355,4.348,11.715,31129,2.656,23.43,3976,4044,24740
2017,33,27467,34849,602725,597865,2640,7.563,2760,7.906,69037,20005,49032,3.346,11.547,59729,17867,41862,2.988,9.99,9308,1.557,19.981,1726,1757,9334
2017,34,171544,209712,3662061,3633936,20275,9.671,20156,9.614,503981,164850,339131,4.536,13.869,446772,140870,305902,3.877,12.294,57209,1.574,24.589,13407,13613,73819
2017,35,30965,40294,625361,626647,3368,8.341,3538,8.762,75167,23627,51540,3.77,11.995,77358,24133,53225,3.851,12.345,-2191,-0.35,23.99,2233,2286,11353
2017,36,405842,485444,8221109,8176687,47576,9.808,46818,9.652,1072245,325132,747113,3.976,13.113,983508,356536,626972,4.36,12.028,88737,1.085,24.056,32497,32941,185440
2017,37,157107,211131,3747135,3706608,20523,9.797,17241,8.23,483648,147744,335904,3.986,13.048,402797,133801,268996,3.61,10.867,80851,2.181,21.734,10853,11150,64293
2017,38,17561,22278,342716,344866,1802,8.044,2050,9.151,43542,14759,28783,4.28,12.626,47516,14329,33187,4.155,13.778,-3974,-1.152,25.252,1333,1353,6766
2017,39,165594,233141,4799224,4781302,17657,7.527,20552,8.761,594206,172819,421387,3.614,12.428,560271,194966,365305,4.078,11.718,33935,0.71,23.436,11119,11530,97992
2017,40,65401,85694,1356574,1354182,7429,8.649,7837,9.124,173986,56148,117838,4.146,12.848,169264,55953,113311,4.132,12.499,4722,0.349,24.999,4897,5012,30069
2017,41,83823,105503,1592433,1569138,10445,9.97,8977,8.568,216955,60521,156434,3.857,13.826,170412,53983,116429,3.44,10.86,46543,2.966,21.72,5952,6045,27760
2017,42,207582,278691,5413367,5376265,21589,7.733,22563,8.082,645844,178336,467508,3.317,12.013,572178,174264,397914,3.241,10.643,73666,1.37,21.285,13755,14055,75700
2017,44,21551,25926,435908,434680,2062,7.949,2089,8.053,50685,13157,37528,3.027,11.66,48570,15433,33137,3.55,11.174,2115,0.487,22.347,1313,1332,8438
2017,45,73981,99396,1745842,1729323,9095,9.211,7782,7.881,227202,68029,159173,3.934,13.138,194200,64875,129325,3.751,11.23,33002,1.908,22.46,4870,4985,33816
2017,46,19759,24382,359169,358320,1897,7.78,1900,7.792,40706,11360,29346,3.17,11.36,39549,11931,27618,3.33,11.037,1157,0.323,22.075,1195,1210,6284
2017,47,90372,127806,2641255,2620531,11087,8.707,10143,7.966,341768,99445,242323,3.795,13.042,299445,99945,199500,3.814,11.427,42323,1.615,22.854,6293,6483,43109
2017,48,392981,539223,10554754,10481880,57076,10.642,51255,9.557,1557260,516737,1040523,4.93,14.857,1413670,464995,948675,4.436,13.487,143590,1.37,26.974,32375,33496,225900
2017,49,55748,68889,1277040,1256459,7967,11.678,6633,9.723,178656,54614,124042,4.347,14.219,138370,47815,90555,3.806,11.013,40286,3.206,22.025,4202,4277,26594
2017,50,15948,19006,258435,259661,1426,7.483,1529,8.023,28038,7415,20623,2.856,10.798,30219,8803,21416,3.39,11.638,-2181,-0.84,21.596,1008,1018,5586
2017,51,136783,184183,3299920,3279085,16407,8.924,15757,8.57,414709,115240,299469,3.514,12.647,372138,117120,255018,3.572,11.349,42571,1.298,22.698,9787,10006,56273
2017,53,134476,169048,2689085,2650521,17589,10.475,15307,9.116,374866,101237,273629,3.82,14.143,296549,92933,203616,3.506,11.188,78317,2.955,22.377,9943,10080,51575
2017,54,24527,34094,547852,553407,2415,7.032,2916,8.49,59341,15745,43596,2.845,10.723,70972,20332,50640,3.674,12.825,-11631,-2.102,21.446,1767,1801,8729
2017,55,97415,129696,2544461,2530063,9827,7.57,10060,7.75,299140,84269,214871,3.331,11.823,270645,86324,184321,3.412,10.697,28495,1.126,21.394,6215,6363,38212
2017,56,15597,18571,199143,203111,1794,9.635,1891,10.156,26005,9380,16625,4.618,12.803,33967,10672,23295,5.254,16.723,-7962,-3.92,25.607,1185,1213,4913
2018,01,68202,93538,1719581,1709199,6724,7.178,6993,7.465,202298,54368,147930,3.181,11.836,183185,48765,134420,2.853,10.718,19113,1.118,21.435,4698,4906,27502
2018,02,14068,18062,260382,260840,1609,8.914,1585,8.781,30657,6780,23877,2.599,11.753,31478,8397,23081,3.219,12.068,-821,-0.315,23.506,1004,1016,3717
2018,04,95532,128049,2536836,2488913,13128,10.31,11689,9.18,358165,113164,245001,4.547,14.39,261520,77798,183722,3.126,10.507,96645,3.883,21.015,7875,8123,45331
2018,05,45883,61416,1038293,1032056,4901,7.992,4712,7.684,119908,33853,86055,3.28,11.618,106761,30234,76527,2.929,10.344,13147,1.274,20.689,3293,3411,19371
2018,06,664784,837075,14989374,14836602,86614,10.399,78255,9.396,1977068,616075,1360993,4.152,13.326,1669517,559402,1110115,3.77,11.253,307551,2.073,22.505,55166,56703,345446
2018,08,120289,149424,2418103,2393181,16358,11.025,14264,9.613,320041,101592,218449,4.245,13.373,270270,91585,178685,3.827,11.293,49771,2.08,22.587,9755,9950,53633
2018,09,63262,81050,1522555,1525163,6418,7.891,6978,8.58,169105,52182,116923,3.421,11.088,174625,56429,118196,3.7,11.45,-5520,-0.362,22.175,4513,4620,30334
2018,10,18079,23008,416493,408212,2285,10.001,1964,8.596,59656,17882,41774,4.381,14.614,43776,12079,31697,2.959,10.724,15880,3.89,21.448,1302,1326,7212
2018,11,16917,21907,536314,530475,1979,9.063,1838,8.417,62419,20034,42385,3.777,11.767,50376,15427,34949,2.908,9.496,12043,2.27,18.993,1065,1078,7231
2018,12,397732,498154,8208517,8090111,57054,11.526,50729,10.248,1139740,400652,739088,4.952,14.088,901280,331722,569558,4.1,11.141,238460,2.948,22.281,35625,36462,186230
2018,13,159833,210959,3964212,3923849,20789,9.898,18946,9.02,530698,159476,371222,4.064,13.525,449147,143883,305264,3.667,11.447,81551,2.078,22.893,12810,13181,75416
2018,15,23145,30234,550427,547002,2448,8.118,2287,7.585,61086,19248,41838,3.519,11.167,53683,16346,37337,2.988,9.814,7403,1.353,19.628,1565,1612,10828
2018,16,34981,42676,595929,586567,4748,11.302,3413,8.125,82873,26795,56078,4.568,14.128,63732,18990,44742,3.237,10.865,19141,3.263,21.731,2387,2453,11771
2018,17,221911,284708,5432460,5420139,23623,8.289,24208,8.494,622246,170778,451468,3.151,11.48,596956,172214,424742,3.177,11.014,25290,0.467,22.027,16428,16857,90317
2018,18,98995,136448,2806905,2790152,10385,7.616,10203,7.483,330418,84627,245791,3.033,11.842,296921,96267,200654,3.45,10.642,33497,1.201,21.284,6583,6905,53864
2018,19,56300,75339,1362371,1356684,5546,7.383,5096,6.784,137395,35234,102161,2.597,10.127,125669,32723,92946,2.412,9.263,11726,0.864,18.526,3403,3588,18564
2018,20,51989,68474,1197583,1196754,5054,7.361,5431,7.91,134163,36819,97344,3.077,11.211,132574,37033,95541,3.094,11.078,1589,0.133,22.156,3731,3840,20883
2018,21,60800,84031,1638486,1630953,6088,7.226,6536,7.757,186673,53585,133088,3.286,11.446,170867,51616,119251,3.165,10.477,15806,0.969,20.953,4408,4562,29243
2018,22,73681,97932,1687835,1686787,7683,7.833,7999,8.155,197146,53625,143521,3.179,11.688,195390,57742,137648,3.423,11.584,1756,0.104,23.167,5353,5644,35019
2018,23,29286,36448,514957,513907,2805,7.699,2778,7.625,54166,13219,40947,2.572,10.54,51975,15242,36733,2.966,10.114,2191,0.426,20.227,1902,1952,9076
2018,24,97850,126487,2358071,2343472,10688,8.455,10535,8.334,277660,77193,200467,3.294,11.848,248070,75160,172910,3.207,10.586,29590,1.263,21.171,6948,7107,41119
2018,25,127735,162437,3342268,3313146,13272,8.178,12994,8.006,396702,117522,279180,3.547,11.974,336323,102761,233562,3.102,10.151,60379,1.822,20.302,8665,8837,51515
2018,26,153549,200741,3913842,3873815,15761,7.859,15398,7.678,475690,118980,356710,3.071,12.28,392193,122195,269998,3.154,10.124,83497,2.155,20.248,10571,10949,71286
2018,27,102348,133756,2693556,2673950,10322,7.699,10953,8.17,310716,79884,230832,2.987,11.62,270919,92808,178111,3.471,10.132,39797,1.488,20.264,7317,7576,57790
2018,28,40743,55245,943795,941753,4103,7.424,4140,7.491,102873,29573,73300,3.14,10.924,99266,28089,71177,2.983,10.541,3607,0.383,21.081,2798,2907,16465
2018,29,104225,138723,2524295,2519602,13115,9.455,13097,9.442,292018,85834,206184,3.407,11.59,281900,87039,194861,3.454,11.188,10118,0.402,22.377,9214,9447,46346
2018,30,28043,33329,369683,373093,3114,9.384,2822,8.504,43005,13814,29191,3.703,11.527,50873,13090,37783,3.509,13.635,-7868,-2.109,23.053,1980,2006,8456
2018,31,38793,49691,841713,836504,3722,7.477,3901,7.836,96108,26445,69663,3.161,11.489,85525,28972,56553,3.463,10.224,10583,1.265,20.448,2585,2665,14077
2018,32,46492,59912,1217856,1203553,7068,11.919,5841,9.85,163057,57492,105565,4.777,13.548,134720,42702,92018,3.548,11.194,28337,2.354,22.387,3993,4115,24119
2018,33,27583,34959,612394,607547,2701,7.739,2586,7.409,69854,22839,47015,3.759,11.498,60153,17066,43087,2.809,9.901,9701,1.597,19.802,1831,1851,9957
2018,34,171568,209502,3721278,3697409,18895,9.015,19085,9.106,470206,145329,324877,3.931,12.717,423021,129443,293578,3.501,11.441,47185,1.276,22.882,13577,13733,67554
2018,35,30905,40070,629769,627694,3243,8.072,3458,8.607,71920,22733,49187,3.622,11.458,67488,21128,46360,3.366,10.752,4432,0.706,21.503,2283,2336,11327
2018,36,406270,485194,8348483,8289041,45886,9.456,46005,9.481,1027699,307063,720636,3.704,12.398,908977,303097,605880,3.657,10.966,118722,1.432,21.932,33481,34076,188699
2018,37,159455,213350,3844689,3807881,19690,9.277,17460,8.227,481074,147442,333632,3.872,12.634,407916,136875,271041,3.595,10.712,73158,1.921,21.425,11617,12015,71446
2018,38,17474,22165,346112,343298,1692,7.615,1799,8.097,42750,11879,30871,3.46,12.453,37374,11057,26317,3.221,10.887,5376,1.566,21.774,1237,1298,6624
2018,39,165056,232037,4853399,4827268,16396,7.05,17455,7.505,564827,150037,414790,3.108,11.701,512808,159379,353429,3.302,10.623,52019,1.078,21.246,11033,11527,77022
2018,40,65452,85575,1383660,1370932,7188,8.395,7281,8.504,179544,51653,127891,3.768,13.096,154691,48783,105908,3.558,11.284,24853,1.813,22.567,5015,5160,27557
2018,41,85271,106856,1625014,1609409,10251,9.656,8867,8.352,197357,53834,143523,3.345,12.263,167190,54693,112497,3.398,10.388,30167,1.874,20.777,6206,6322,32171
2018,42,207526,278212,5465833,5444243,20152,7.238,20547,7.38,591575,155396,436179,2.854,10.866,547617,162222,385395,2.98,10.059,43958,0.807,20.117,13558,13918,78596
2018,44,21511,25770,442003,438710,2079,8.052,2179,8.439,53672,14239,39433,3.246,12.234,46601,16705,29896,3.808,10.622,7071,1.612,21.245,1390,1433,7797
2018,45,75208,100594,1803173,1779623,9082,9.081,7906,7.906,239598,70357,169241,3.953,13.463,192794,61149,131645,3.436,10.833,46804,2.63,21.667,5281,5472,29974
2018,46,19824,24436,359121,359475,1936,7.933,1873,7.675,35678,9961,25717,2.771,9.925,36248,11657,24591,3.243,10.084,-570,-0.159,19.85,1308,1349,6821
2018,47,90996,128382,2664137,2650261,10353,8.083,9765,7.624,302304,83836,218468,3.163,11.407,274728,81262,193466,3.066,10.366,27576,1.041,20.732,6469,6778,43659
2018,48,398943,545430,10787351,10674934,55135,10.168,48772,8.994,1472579,471799,1000780,4.42,13.795,1247894,392624,855270,3.678,11.69,224685,2.105,23.38,33488,34646,228183
2018,49,57419,70512,1333817,1306194,8049,11.549,6415,9.204,184698,55455,129243,4.246,14.14,129898,47271,82627,3.619,9.945,54800,4.195,19.89,4371,4483,31003
2018,50,15863,18900,261294,259866,1310,6.913,1408,7.43,26461,7697,18764,2.962,10.183,23830,8014,15816,3.084,9.17,2631,1.012,18.34,990,1004,5177
2018,51,137263,184446,3377144,3340171,15833,8.591,15533,8.428,415199,115541,299658,3.459,12.43,342013,104422,237591,3.126,10.239,73186,2.191,20.479,10144,10430,55796
2018,53,136904,171309,2769823,2731089,17384,10.215,15119,8.884,365043,109918,255125,4.025,13.366,287818,95303,192515,3.49,10.539,77225,2.828,21.077,10488,10777,54298
2018,54,24109,33621,554785,551454,2192,6.474,2664,7.868,65183,17779,47404,3.224,11.82,58598,18814,39784,3.412,10.626,6585,1.194,21.252,1804,1847,10592
2018,55,97527,129492,2597332,2577235,9261,7.148,9393,7.25,282513,74677,207836,2.898,10.962,242941,71578,171363,2.777,9.426,39572,1.535,18.853,6243,6457,34931
2018,56,15798,18704,205178,203046,1894,10.164,1755,9.418,27513,9080,18433,4.472,13.55,23227,8548,14679,4.21,11.439,4286,2.111,22.879,1211,1247,5269
2019,01,68495,94175,1756564,1738276,7316,7.794,6701,7.139,200168,57438,142730,3.304,11.515,164726,48344,116382,2.781,9.476,35442,2.039,18.953,4949,5097,28823
2019,02,14062,18036,262722,261246,1582,8.778,1554,8.623,30673,8456,22217,3.237,11.741,27657,7172,20485,2.745,10.587,3016,1.154,21.173,1147,1165,4205
2019,04,96765,129509,2605217,2572447,13118,10.185,11687,9.074,343784,111651,232133,4.34,13.364,278214,97178,181036,3.778,10.815,65570,2.549,21.63,8584,8739,55314
2019,05,45973,61709,1053854,1046050,5102,8.286,4833,7.849,120165,37789,82376,3.613,11.488,105257,34144,71113,3.264,10.062,14908,1.425,20.125,3600,3773,22705
2019,06,674532,847415,15312308,15146741,89188,10.589,78903,9.368,1988741,664272,1324469,4.386,13.13,1660085,551207,1108878,3.639,10.96,328656,2.17,21.92,60793,62019,348595
2019,08,121649,151159,2437720,2412625,16715,11.122,14981,9.968,317635,104609,213026,4.336,13.166,267049,92029,175020,3.814,11.069,50586,2.097,22.138,11410,11552,59884
2019,09,63036,81103,1537010,1532353,6361,7.845,6323,7.798,155267,45710,109557,2.983,10.133,145018,43961,101057,2.869,9.464,10249,0.669,18.927,4756,4826,26006
2019,10,18429,23382,433016,424795,2270,9.784,1910,8.232,58250,15052,43198,3.543,13.713,42267,16237,26030,3.822,9.95,15983,3.763,19.9,1406,1424,7051
2019,11,16997,22057,527785,532618,1937,8.811,1791,8.147,53955,18475,35480,3.469,10.13,64185,18765,45420,3.523,12.051,-10230,-1.921,20.26,1202,1222,9864
2019,12,404286,506282,8378309,8297721,58959,11.739,50863,10.127,1046261,377697,668564,4.552,12.609,887993,315964,572029,3.808,10.702,158268,1.907,21.403,40163,40741,201927
2019,13,161754,213854,4056312,4017646,21534,10.137,18673,8.79,533118,171017,362101,4.257,13.269,455327,152530,302797,3.797,11.333,77791,1.936,22.666,14160,14413,79456
2019,15,23208,30317,554661,552719,2436,8.045,2360,7.794,56165,19855,36310,3.592,10.162,52217,18279,33938,3.307,9.447,3948,0.714,18.895,1790,1819,11252
2019,16,36169,43943,615753,606069,4888,11.284,3635,8.392,76054,26998,49056,4.455,12.549,56883,17379,39504,2.867,9.386,19171,3.163,18.771,2795,2839,11106
2019,17,221368,284593,5476412,5455163,24049,8.448,24209,8.504,593092,179302,413790,3.287,10.872,551915,167127,384788,3.064,10.117,41177,0.755,20.235,18313,18752,99778
2019,18,98826,137087,2828297,2817521,10240,7.486,9630,7.04,276274,75266,201008,2.671,9.806,253408,68578,184830,2.434,8.994,22866,0.812,17.988,7256,7494,43214
2019,19,55985,75136,1379694,1369644,5155,6.851,5379,7.148,139246,32404,106842,2.366,10.167,119499,33584,85915,2.452,8.725,19747,1.442,17.45,4010,4124,22013
2019,20,51698,68299,1204943,1200806,5196,7.598,5377,7.862,129494,38078,91416,3.171,10.784,121466,36548,84918,3.044,10.115,8028,0.669,20.231,4071,4206,22635
2019,21,60901,84347,1666095,1652666,6506,7.729,6159,7.317,182311,56711,125600,3.431,11.031,155793,47056,108737,2.847,9.427,26518,1.605,18.854,4490,4634,26070
2019,22,73702,98082,1722241,1704881,7788,7.946,7645,7.8,206904,72390,134514,4.246,12.136,172310,52189,120121,3.061,10.107,34594,2.029,20.214,5890,6006,35746
2019,23,29380,36653,522698,518838,3006,8.225,2794,7.645,55733,13956,41777,2.69,10.742,47958,14325,33633,2.761,9.243,7775,1.499,18.487,2129,2156,8585
2019,24,97970,126695,2379174,2369242,10436,8.243,10242,8.09,253558,75344,178214,3.18,10.702,233634,72383,161251,3.055,9.861,19924,0.841,19.722,7602,7792,41494
2019,25,128688,163865,3395555,3358582,13827,8.475,12416,7.61,368120,102286,265834,3.046,10.961,295447,93073,202374,2.771,8.797,72673,2.164,17.594,9314,9494,50940
2019,26,152737,200311,3919878,3901317,15217,7.59,15569,7.766,413511,107400,306111,2.753,10.599,376999,101083,275916,2.591,9.663,36512,0.936,19.327,11983,12200,65551
2019,27,102182,133812,2702565,2696816,10379,7.758,10339,7.728,281269,88749,192520,3.291,10.43,269586,75207,194379,2.789,9.996,11683,0.433,19.993,7714,7938,46938
2019,28,40613,55208,957121,950476,3990,7.224,4042,7.318,101137,29338,71799,3.087,10.641,88210,25529,62681,2.686,9.281,12927,1.36,18.561,3080,3158,16175
2019,29,104070,138685,2544574,2534380,12678,9.16,12123,8.759,271654,81926,189728,3.233,10.719,253233,80985,172248,3.195,9.992,18421,0.727,19.984,9102,9288,43310
2019,30,28234,33569,374574,372870,3092,9.244,2855,8.535,41569,13064,28505,3.504,11.148,38220,12047,26173,3.231,10.25,3349,0.898,20.5,2255,2285,9375
2019,31,38747,49743,854395,848846,3722,7.486,3680,7.401,92009,28794,63215,3.392,10.839,80865,21299,59566,2.509,9.526,11144,1.313,19.053,2750,2782,13039
2019,32,47273,60814,1260441,1239454,6901,11.432,6006,9.949,169301,54822,114479,4.423,13.659,127633,43918,83715,3.543,10.298,41668,3.362,20.595,4644,4729,29537
2019,33,27724,35159,619850,616080,2709,7.727,2511,7.162,59976,16371,43605,2.657,9.735,53253,15207,38046,2.468,8.644,6723,1.091,17.288,1920,1931,8832
2019,34,172153,210568,3792064,3756989,19792,9.422,18759,8.931,451812,138496,313316,3.686,12.026,383768,125532,258236,3.341,10.215,68044,1.811,20.43,14617,14838,77143
2019,35,30906,40132,633643,631717,3340,8.329,3277,8.172,70975,22016,48959,3.485,11.235,67869,18823,49046,2.98,10.744,3106,0.492,21.487,2513,2561,13010
2019,36,406925,486992,8499941,8412363,46044,9.472,44290,9.111,1029834,319215,710619,3.795,12.242,857565,276805,580760,3.29,10.194,172269,2.048,20.388,35611,36190,191385
2019,37,161157,215725,3929952,3886586,19163,8.932,16804,7.832,475358,139198,336160,3.581,12.231,393053,137974,255079,3.55,10.113,82305,2.118,20.226,12804,13067,70829
2019,38,17533,22302,356177,351281,1724,7.754,1590,7.151,40034,14502,25532,4.128,11.397,30531,8575,21956,2.441,8.691,9503,2.705,17.383,1216,1247,5594
2019,39,164675,231334,4913021,4883481,16572,7.152,17319,7.475,525779,152318,373461,3.119,10.766,468094,144834,323260,2.966,9.585,57685,1.181,19.171,11892,12194,77193
2019,40,65587,85750,1403381,1393860,7396,8.633,7242,8.453,168547,51435,117112,3.69,12.092,150471,42965,107506,3.082,10.795,18076,1.297,21.591,5440,5632,28429
2019,41,85637,107407,1642125,1633586,9891,9.233,9327,8.707,188149,53820,134329,3.295,11.518,171615,51984,119631,3.182,10.505,16534,1.012,21.011,7160,7298,33063
2019,42,208187,279240,5551326,5508112,20885,7.493,19874,7.13,578484,160546,417938,2.915,10.502,493824,157096,336728,2.852,8.965,84660,1.537,17.931,14555,15040,87990
2019,44,21625,25946,444304,443116,2247,8.69,2067,7.994,46782,16264,30518,3.67,10.558,44516,13047,31469,2.944,10.046,2266,0.511,20.092,1530,1551,8353
2019,45,76074,101862,1852001,1827432,9188,9.076,7940,7.843,239737,70839,168898,3.876,13.119,191931,61948,129983,3.39,10.503,47806,2.616,21.006,5991,6131,41366
2019,46,19824,24454,359678,359426,1894,7.747,1880,7.69,33264,10085,23179,2.806,9.255,33114,9171,23943,2.552,9.213,150,0.042,18.426,1467,1492,6357
2019,47,91358,129586,2720373,2698013,11003,8.529,9831,7.621,313252,102066,211186,3.783,11.61,268441,81906,186535,3.036,9.95,44811,1.661,19.899,7156,7308,42558
2019,48,405653,553974,11075495,10930378,56433,10.265,48009,8.733,1450355,470814,979541,4.307,13.269,1168338,381411,786927,3.489,10.689,282017,2.58,21.378,36333,37406,232449
2019,49,58817,71946,1373257,1353217,8134,11.418,6725,9.44,172541,54595,117946,4.034,12.75,132998,42492,90506,3.14,9.828,39543,2.922,19.657,5182,5254,29172
2019,50,15711,18757,260761,261217,1326,7.043,1467,7.792,23072,6502,16570,2.489,8.833,24227,7859,16368,3.009,9.275,-1155,-0.442,17.665,1151,1162,5332
2019,51,138162,185882,3446986,3413743,16051,8.667,14670,7.922,396564,111852,284712,3.277,11.617,331025,101948,229077,2.986,9.697,65539,1.92,19.394,11057,11245,63076
2019,53,137843,172653,2820626,2795218,16969,9.866,15648,9.098,335578,105846,229732,3.787,12.005,285709,93606,192103,3.349,10.221,49869,1.784,20.443,12086,12321,60360
2019,54,23925,33517,556448,555979,2329,6.938,2437,7.259,60055,20082,39973,3.612,10.802,59306,19330,39976,3.477,10.667,749,0.135,21.334,1812,1841,11708
2019,55,97237,129724,2610167,2603031,9309,7.182,9099,7.02,273572,86608,186964,3.327,10.51,259705,68022,191683,2.613,9.977,13867,0.533,19.954,6764,6917,41556
2019,56,15900,18827,207348,206012,1843,9.823,1714,9.135,24015,8029,15986,3.897,11.657,21288,6444,14844,3.128,10.333,2727,1.324,20.667,1339,1360,5005
